"1","Aggregation.java","50436","118362","168798","50436","50436.0"
"1","AlterTable.java","145048","281457","426505","145048","145048.0"
"1","AlterTableOpType.java","0","0","0","0","0"
"1","AlterTablespace.java","0","0","0","0","0"
"1","AlterTablespaceSetType.java","0","0","0","0","0"
"1","BetweenPredicate.java","22356","53157","75513","22356","22356.0"
"1","BinaryOperator.java","40534","114409","154943","40534","40534.0"
"1","BooleanLiteral.java","0","0","0","0","0"
"1","CaseWhenPredicate.java","50436","118362","168798","50436","50436.0"
"1","CastExpr.java","24132","68238","92370","24132","24132.0"
"1","ColumnDefinition.java","115795","131461","247256","115795","115795.0"
"1","ColumnReferenceExpr.java","33422","90520","123942","33422","33422.0"
"1","CommonSubquery.java","0","0","0","0","0"
"1","CountRowsFunctionExpr.java","0","0","0","0","0"
"1","CreateDatabase.java","114468","134996","249464","114468","114468.0"
"1","CreateIndex.java","0","0","0","0","0"
"1","CreateTable.java","36108","89962","126070","44260","44260.0"
"1","DataTypeExpr.java","24132","68238","92370","24132","24132.0"
"1","DateLiteral.java","0","0","0","0","0"
"1","DateValue.java","0","0","0","0","0"
"1","DropDatabase.java","114468","134996","249464","114468","114468.0"
"1","DropIndex.java","0","0","0","0","0"
"1","DropTable.java","47396","96507","143903","47396","47396.0"
"1","ExistsPredicate.java","0","0","0","0","0"
"1","Explain.java","152138","291070","443208","152138","152138.0"
"1","Expr.java","82133","191653","273786","82133","82133.0"
"1","ExprVisitor.java","0","0","0","0","0"
"1","FunctionExpr.java","50436","118362","168798","50436","50436.0"
"1","GeneralSetFunctionExpr.java","8929","34848","43777","8929","8929.0"
"1","Having.java","40534","114409","154943","40534","40534.0"
"1","InPredicate.java","82133","191653","273786","82133","82133.0"
"1","Insert.java","33046","100368","133414","33046","33046.0"
"1","IntervalLiteral.java","0","0","0","0","0"
"1","IsNullPredicate.java","50436","118362","168798","50436","50436.0"
"1","Join.java","50436","118362","168798","50436","50436.0"
"1","JoinType.java","0","0","0","0","0"
"1","JsonHelper.java","82133","191653","273786","82133","82133.0"
"1","JsonSerializable.java","0","0","0","0","0"
"1","Limit.java","40534","114409","154943","40534","40534.0"
"1","LiteralValue.java","50436","118362","168798","50436","50436.0"
"1","NamedExpr.java","0","0","0","0","0"
"1","NotExpr.java","0","0","0","0","0"
"1","NullLiteral.java","48415","106907","155322","48415","48415.0"
"1","OpType.java","47476","104167","151643","47476","47476.0"
"1","PatternMatchPredicate.java","33390","89370","122760","33390","33390.0"
"1","Projection.java","50436","118362","168798","50436","50436.0"
"1","QualifiedAsteriskExpr.java","0","0","0","0","0"
"1","Relation.java","40534","114409","154943","40534","40534.0"
"1","RelationList.java","40534","114409","154943","40534","40534.0"
"1","ScalarSubQuery.java","0","0","0","0","0"
"1","Selection.java","40534","114409","154943","40534","40534.0"
"1","SetOperation.java","50436","118362","168798","50436","50436.0"
"1","SetSession.java","0","0","0","0","0"
"1","SignedExpr.java","16836","34771","51607","16836","16836.0"
"1","SimpleTableSubquery.java","84209","390783","474992","84209","84209.0"
"1","Sort.java","50436","118362","168798","50436","50436.0"
"1","TablePrimarySubQuery.java","84209","390783","474992","84209","84209.0"
"1","TimeLiteral.java","0","0","0","0","0"
"1","TimestampLiteral.java","0","0","0","0","0"
"1","TimeValue.java","125703","176731","302434","125703","125703.0"
"1","TruncateTable.java","0","0","0","0","0"
"1","UnaryOperator.java","0","0","0","0","0"
"1","ValueListExpr.java","82133","191653","273786","82133","82133.0"
"1","Window.java","0","0","0","0","0"
"1","WindowFunctionExpr.java","120710","143085","263795","120710","120710.0"
"1","WindowSpec.java","69654","171066","240720","69654","69654.0"
"1","AlgebraTestingUtil.java","0","0","0","0","0"
"1","TestExpr.java","50436","118362","168798","50436","50436.0"
"1","AbstractCatalogClient.java","51164","121407","172571","51164","51164.0"
"1","CatalogClient.java","83576","334269","417845","83576","83576.0"
"1","AlreadyRegisteredURIException.java","0","0","0","0","0"
"1","AlterTableDesc.java","1559","8505","10064","1559","1559.0"
"1","AlterTableType.java","0","0","0","0","0"
"1","AttributeType.java","0","0","0","0","0"
"1","CatalogConstants.java","0","0","0","0","0"
"1","CatalogService.java","51164","121407","172571","51164","51164.0"
"1","CatalogUtil.java","51164","121407","172571","51164","51164.0"
"1","Column.java","60749","138539","199288","60749","60749.0"
"1","DDLBuilder.java","23279","48434","71713","23279","23279.0"
"1","FieldConverter.java","0","0","0","0","0"
"1","FunctionDesc.java","47419","103169","150588","47419","47419.0"
"1","FunctionDescBuilder.java","0","0","0","0","0"
"1","IndexDesc.java","61564","150556","212120","61564","61564.0"
"1","IndexMeta.java","0","0","0","0","0"
"1","CatalogGsonHelper.java","0","0","0","0","0"
"1","FunctionAdapter.java","0","0","0","0","0"
"1","SchemaAdapter.java","0","0","0","0","0"
"1","TableMetaAdapter.java","82589","292140","374729","82589","82589.0"
"1","ListSchemaBuilder.java","0","0","0","0","0"
"1","MetadataProvider.java","110444","136696","247140","110444","110444.0"
"1","NestedPathUtil.java","0","0","0","0","0"
"1","PartitionDesc.java","1814","2898","4712","1814","1814.0"
"1","PartitionMethodDesc.java","23850","30434","54284","23850","23850.0"
"1","Schema.java","50436","118362","168798","50436","50436.0"
"1","SchemaBuilder.java","0","0","0","0","0"
"1","SchemaFactory.java","0","0","0","0","0"
"1","SchemaLegacy.java","0","0","0","0","0"
"1","SchemaObject.java","0","0","0","0","0"
"1","SchemaUtil.java","50436","118362","168798","50436","50436.0"
"1","SetSchemaBuilder.java","0","0","0","0","0"
"1","SortSpec.java","60663","137490","198153","60663","60663.0"
"1","ColumnStats.java","50133","157758","207891","50133","50133.0"
"1","Stat.java","0","0","0","0","0"
"1","StatisticsUtil.java","59628","131090","190718","59628","59628.0"
"1","StatSet.java","60663","137490","198153","60663","60663.0"
"1","TableStats.java","49676","111893","161569","49676","49676.0"
"1","TableDesc.java","8465","19149","27614","8465","8465.0"
"1","TableMeta.java","110825","208854","319679","110825","110825.0"
"1","TypeConverter.java","0","0","0","0","0"
"1","TypeDesc.java","0","0","0","0","0"
"1","DataTypeUtil.java","0","0","0","0","0"
"1","ClassBaseInvocationDesc.java","0","0","0","0","0"
"1","Function.java","0","0","0","0","0"
"1","FunctionCollection.java","0","0","0","0","0"
"1","FunctionInvocation.java","92487","142115","234602","92487","92487.0"
"1","FunctionSignature.java","93100","145230","238330","93100","93100.0"
"1","FunctionSupplement.java","0","0","0","0","0"
"1","FunctionUtil.java","93100","145230","238330","93100","93100.0"
"1","ScalarFunction.java","0","0","0","0","0"
"1","StaticMethodInvocationDesc.java","0","0","0","0","0"
"1","UDFInvocationDesc.java","1668","4550","6218","1668","1668.0"
"1","TestColumnStat.java","0","0","0","0","0"
"1","TestStatisticsUtil.java","0","0","0","0","0"
"1","TestStatSet.java","0","0","0","0","0"
"1","TestTableStat.java","82121","210050","292171","82121","82121.0"
"1","TestCatalogUtil.java","61564","150556","212120","61564","61564.0"
"1","TestColumn.java","0","0","0","0","0"
"1","TestFunctionDesc.java","50514","119658","170172","50514","50514.0"
"1","TestIndexDesc.java","84059","384589","468648","84059","84059.0"
"1","TestKeyValueSet.java","82117","188494","270611","82117","82117.0"
"1","TestSchema.java","47541","105513","153054","47541","47541.0"
"1","TestTableDesc.java","83566","379726","463292","83566","83566.0"
"1","TestTableMeta.java","75228","333817","409045","75228","75228.0"
"1","HCatalogStore.java","0","0","0","0","0"
"1","HiveCatalogStore.java","21120","51976","73096","21120","21120.0"
"1","HiveCatalogStoreClientPool.java","31004","45244","76248","31004","31004.0"
"1","HiveCatalogUtil.java","47382","96987","144369","47382","47382.0"
"1","TestHiveCatalogStore.java","948","1690","2638","948","948.0"
"1","CatalogServer.java","51164","121407","172571","51164","51164.0"
"1","AbstractTableDescriptor.java","0","0","0","0","0"
"1","ClusterTableDescriptor.java","0","0","0","0","0"
"1","ColumnDescriptor.java","0","0","0","0","0"
"1","ColumnsTableDescriptor.java","0","0","0","0","0"
"1","DatabasesTableDescriptor.java","0","0","0","0","0"
"1","IndexesTableDescriptor.java","0","0","0","0","0"
"1","InfoSchemaMetadataDictionary.java","46802","104730","151532","46802","46802.0"
"1","PartitionKeysTableDescriptor.java","0","0","0","0","0"
"1","PartitionsTableDescriptor.java","0","0","0","0","0"
"1","SessionTableDescriptor.java","0","0","0","0","0"
"1","TableDescriptor.java","0","0","0","0","0"
"1","TableOptionsTableDescriptor.java","0","0","0","0","0"
"1","TablespacesTableDescriptor.java","0","0","0","0","0"
"1","TablesTableDescriptor.java","0","0","0","0","0"
"1","TableStatsTableDescriptor.java","0","0","0","0","0"
"1","LinkedMetadataManager.java","109588","120665","230253","109588","109588.0"
"1","LocalCatalogWrapper.java","61023","144960","205983","61023","61023.0"
"1","AbstractDBStore.java","22729","44967","67696","22729","22729.0"
"1","CatalogStore.java","51164","121407","172571","51164","51164.0"
"1","DerbyStore.java","33992","78568","112560","33992","33992.0"
"1","MariaDBStore.java","86193","201886","288079","86193","86193.0"
"1","MySQLStore.java","56589","119914","176503","56589","56589.0"
"1","BaseSchema.java","0","0","0","0","0"
"1","DatabaseObject.java","0","0","0","0","0"
"1","DatabaseObjectType.java","0","0","0","0","0"
"1","SchemaPatch.java","0","0","0","0","0"
"1","SQLObject.java","0","0","0","0","0"
"1","StoreObject.java","0","0","0","0","0"
"1","OracleStore.java","40175","49688","89863","40175","40175.0"
"1","PostgreSQLStore.java","39847","49818","89665","39847","39847.0"
"1","XMLCatalogSchemaManager.java","56560","78499","135059","56560","56560.0"
"1","CatalogTestingUtil.java","3578","4807","8385","3578","3578.0"
"1","MiniCatalogServer.java","0","0","0","0","0"
"1","TestXMLCatalogSchemaManager.java","41348","61884","103232","41348","41348.0"
"1","TestCatalog.java","47331","95236","142567","47331","47331.0"
"1","TestCatalogAgainstCaseSensitivity.java","4220","26048","30268","4220","4220.0"
"1","TestCatalogExceptions.java","3451","24548","27999","3451","3451.0"
"1","TestLinkedMetadataManager.java","100438","105248","205686","100438","100438.0"
"1","TajoAdmin.java","4570","10715","15285","4570","4570.0"
"1","TajoDump.java","55626","121868","177494","55626","55626.0"
"1","TajoGetConf.java","0","0","0","0","0"
"1","TajoHAAdmin.java","82345","174806","257151","82345","82345.0"
"1","CliClientParamsFactory.java","0","0","0","0","0"
"1","ConnectDatabaseCommand.java","148691","362497","511188","148691","148691.0"
"1","CopyrightCommand.java","0","0","0","0","0"
"1","DescFunctionCommand.java","37445","56684","94129","37445","37445.0"
"1","DescTableCommand.java","3837","4327","8164","3837","3837.0"
"1","ExecExternalShellCommand.java","119457","140026","259483","119457","119457.0"
"1","ExitCommand.java","0","0","0","0","0"
"1","HdfsCommand.java","0","0","0","0","0"
"1","HelpCommand.java","37445","56684","94129","37445","37445.0"
"1","ListDatabaseCommand.java","0","0","0","0","0"
"1","SetCommand.java","116292","162550","278842","116292","116292.0"
"1","TajoAdminCommand.java","131588","230366","361954","131588","131588.0"
"1","TajoGetConfCommand.java","40262","105070","145332","40262","40262.0"
"1","TajoHAAdminCommand.java","82011","174358","256369","82011","82011.0"
"1","TajoShellCommand.java","37445","56684","94129","37445","37445.0"
"1","UnsetCommand.java","0","0","0","0","0"
"1","VersionCommand.java","37445","56684","94129","37445","37445.0"
"1","DefaultTajoCliOutputFormatter.java","311","1974","2285","311","311.0"
"1","InvalidStatementException.java","61564","150556","212120","61564","61564.0"
"1","ParsedResult.java","61564","150556","212120","61564","61564.0"
"1","SimpleParser.java","1940","11496","13436","1940","1940.0"
"1","TajoCli.java","50524","120277","170801","50524","50524.0"
"1","TajoCliOutputFormatter.java","0","0","0","0","0"
"1","TajoFileHistory.java","61564","150556","212120","61564","61564.0"
"1","CatalogAdminClient.java","85925","189379","275304","85925","85925.0"
"1","CatalogAdminClientImpl.java","64266","117883","182149","64266","64266.0"
"1","ClientParameterHelper.java","0","0","0","0","0"
"1","ClientParameters.java","0","0","0","0","0"
"1","DummyServiceTracker.java","19961","43005","62966","19961","19961.0"
"1","InvalidClientSessionException.java","84062","386860","470922","84062","84062.0"
"1","QueryClient.java","5813","15959","21772","5813","5813.0"
"1","QueryClientImpl.java","5813","15959","21772","5813","5813.0"
"1","QueryStatus.java","81830","184912","266742","81830","81830.0"
"1","ResultSetUtil.java","45777","87171","132948","45777","45777.0"
"1","SessionConnection.java","10010","25416","35426","10010","10010.0"
"1","TajoClient.java","97990","103158","201148","97990","97990.0"
"1","TajoClientImpl.java","5813","15959","21772","5813","5813.0"
"1","TajoClientUtil.java","10010","25416","35426","10010","10010.0"
"1","ClientDelegate.java","0","0","0","0","0"
"1","ClientDelegateFactory.java","0","0","0","0","0"
"1","ClientUtil.java","0","0","0","0","0"
"1","ClientConnectionException.java","0","0","0","0","0"
"1","ClientUnableToConnectException.java","0","0","0","0","0"
"1","FutureListener.java","0","0","0","0","0"
"1","LegacyClientDelegate.java","3446","5585","9031","3446","3446.0"
"1","QueryFuture.java","0","0","0","0","0"
"1","QueryState.java","0","0","0","0","0"
"1","ServiceDiscovery.java","0","0","0","0","0"
"1","TajoClient.java","97990","103158","201148","97990","97990.0"
"1","FetchResultSet.java","83970","122968","206938","83970","83970.0"
"1","MetaDataTuple.java","23225","51528","74753","23225","23225.0"
"1","TajoMemoryResultSet.java","149253","281327","430580","149253","149253.0"
"1","TajoMetaDataResultSet.java","113969","179575","293544","113969","113969.0"
"1","TajoResultSetBase.java","49314","96513","145827","49314","49314.0"
"1","TajoResultSetMetaData.java","49314","96513","145827","49314","49314.0"
"1","TajoSQLException.java","0","0","0","0","0"
"1","WaitingResultSet.java","0","0","0","0","0"
"1","RowStoreUtil.java","47415","100369","147784","47415","47415.0"
"1","TableExample.java","0","0","0","0","0"
"1","TajoClientAsyncExample.java","0","0","0","0","0"
"1","TajoClientExample.java","0","0","0","0","0"
"1","BackendTestingUtil.java","90361","388943","479304","90361","90361.0"
"1","CatalogTestingUtil.java","3578","4807","8385","3578","3578.0"
"1","HBaseTestClusterUtil.java","24","192","216","24","24.0"
"1","IntegrationTest.java","0","0","0","0","0"
"1","LocalTajoTestingUtility.java","51998","118250","170248","51998","51998.0"
"1","NamedTest.java","0","0","0","0","0"
"1","QueryTestCaseBase.java","28637","39036","67673","28637","28637.0"
"1","TajoTestingCluster.java","60888","140564","201452","60888","60888.0"
"1","TpchTestBase.java","84219","392901","477120","84219","84219.0"
"1","NotNull.java","0","0","0","0","0"
"1","NotThreadSafe.java","0","0","0","0","0"
"1","Nullable.java","0","0","0","0","0"
"1","ThreadSafe.java","0","0","0","0","0"
"1","Assert.java","0","0","0","0","0"
"1","UserRoleInfo.java","0","0","0","0","0"
"1","BuiltinStorages.java","0","0","0","0","0"
"1","ProtoObject.java","0","0","0","0","0"
"1","Sleeper.java","0","0","0","0","0"
"1","IPv4.java","59686","132242","191928","59686","59686.0"
"1","TajoTypeUtil.java","0","0","0","0","0"
"1","TimeRange.java","0","0","0","0","0"
"1","TajoConf.java","47320","92989","140309","47320","47320.0"
"1","ConfigKey.java","0","0","0","0","0"
"1","AnyDatum.java","0","0","0","0","0"
"1","BitDatum.java","48415","106732","155147","48415","48415.0"
"1","BlobDatum.java","46290","88181","134471","46290","46290.0"
"1","BooleanDatum.java","48415","106732","155147","48415","48415.0"
"1","CharDatum.java","51302","121398","172700","51302","51302.0"
"1","DateDatum.java","3122","8485","11607","3122","3122.0"
"1","Datum.java","48415","106732","155147","48415","48415.0"
"1","DatumFactory.java","28913","75702","104615","28913","28913.0"
"1","Float4Datum.java","47303","91302","138605","47303","47303.0"
"1","Float8Datum.java","47303","91302","138605","47303","47303.0"
"1","Int2Datum.java","47303","91302","138605","47303","47303.0"
"1","Int4Datum.java","47303","91302","138605","47303","47303.0"
"1","Int8Datum.java","48415","106732","155147","48415","48415.0"
"1","IntervalDatum.java","303","975","1278","303","303.0"
"1","NullDatum.java","48415","106732","155147","48415","48415.0"
"1","NumericDatum.java","47350","97341","144691","47350","47350.0"
"1","AbstractCharBasedFormatter.java","0","0","0","0","0"
"1","ProtobufFormatter.java","0","0","0","0","0"
"1","ProtobufJsonFormat.java","0","0","0","0","0"
"1","TextUtils.java","96263","306594","402857","96263","96263.0"
"1","ProtobufDatum.java","0","0","0","0","0"
"1","ProtobufDatumFactory.java","98160","405035","503195","98160","98160.0"
"1","TextDatum.java","47303","91302","138605","47303","47303.0"
"1","TimeDatum.java","3118","8132","11250","3118","3118.0"
"1","TimestampDatum.java","857","1939","2796","857","857.0"
"1","AmbiguousColumnException.java","0","0","0","0","0"
"1","AmbiguousFunctionException.java","3446","5585","9031","3446","3446.0"
"1","AmbiguousPartitionDirectoryExistException.java","24737","27752","52489","24737","24737.0"
"1","AmbiguousTableException.java","0","0","0","0","0"
"1","CannotDropCurrentDatabaseException.java","84547","420781","505328","84547","84547.0"
"1","CatalogUpgradeRequiredException.java","84208","389145","473353","84208","84208.0"
"1","DataTypeMismatchException.java","84062","386860","470922","84062","84062.0"
"1","DefaultTajoException.java","84208","389145","473353","84208","84208.0"
"1","DividedByZeroException.java","84547","420781","505328","84547","84547.0"
"1","DuplicateColumnException.java","83983","380705","464688","83983","83983.0"
"1","DuplicateDatabaseException.java","83983","380705","464688","83983","83983.0"
"1","DuplicateFunctionException.java","84062","386860","470922","84062","84062.0"
"1","DuplicateIndexException.java","84208","389145","473353","84208","84208.0"
"1","DuplicatePartitionException.java","84208","389145","473353","84208","84208.0"
"1","DuplicateTableException.java","84208","389145","473353","84208","84208.0"
"1","DuplicateTablespaceException.java","83983","380705","464688","83983","83983.0"
"1","ErrorMessages.java","1011","1614","2625","1011","1011.0"
"1","ErrorUtil.java","0","0","0","0","0"
"1","ExceptionUtil.java","11470","19685","31155","11470","11470.0"
"1","InsufficientPrivilegeException.java","3254","3963","7217","3254","3254.0"
"1","InvalidAddressException.java","0","0","0","0","0"
"1","InvalidDataTypeException.java","114440","374153","488593","114440","114440.0"
"1","InvalidInputsForCrossJoin.java","0","0","0","0","0"
"1","InvalidNameException.java","83983","380705","464688","83983","83983.0"
"1","InvalidOperationException.java","0","0","0","0","0"
"1","InvalidSessionException.java","84062","386860","470922","84062","84062.0"
"1","InvalidSessionVariableException.java","84547","420781","505328","84547","84547.0"
"1","InvalidTablePropertyException.java","84062","386860","470922","84062","84062.0"
"1","InvalidURLException.java","84547","420781","505328","84547","84547.0"
"1","InvalidValueForCastException.java","84377","410628","495005","84377","84377.0"
"1","LMDNoMatchedDatatypeException.java","84062","386860","470922","84062","84062.0"
"1","MetadataConnectionException.java","83983","380705","464688","83983","83983.0"
"1","MissingTablePropertyException.java","84062","386860","470922","84062","84062.0"
"1","NoSuchSessionVariableException.java","83983","380705","464688","83983","83983.0"
"1","NotImplementedException.java","0","0","0","0","0"
"1","QueryFailedException.java","84062","386860","470922","84062","84062.0"
"1","QueryKilledException.java","84062","386860","470922","84062","84062.0"
"1","QueryNotFoundException.java","84062","386860","470922","84062","84062.0"
"1","ReturnStateUtil.java","7595","11403","18998","7595","7595.0"
"1","SQLExceptionUtil.java","8785","14861","23646","8785","8785.0"
"1","SQLSyntaxError.java","0","0","0","0","0"
"1","TajoError.java","8785","14861","23646","8785","8785.0"
"1","TajoException.java","8785","14861","23646","8785","8785.0"
"1","TajoInternalError.java","114440","374153","488593","114440","114440.0"
"1","TajoRuntimeException.java","1011","1614","2625","1011","1011.0"
"1","TooLargeInputForCrossJoinException.java","0","0","0","0","0"
"1","UnavailableTableLocationException.java","84062","386860","470922","84062","84062.0"
"1","UndefinedColumnException.java","83983","380705","464688","83983","83983.0"
"1","UndefinedDatabaseException.java","83983","380705","464688","83983","83983.0"
"1","UndefinedFunctionException.java","84062","386860","470922","84062","84062.0"
"1","UndefinedIndexException.java","83983","380705","464688","83983","83983.0"
"1","UndefinedOperatorException.java","114440","374153","488593","114440","114440.0"
"1","UndefinedPartitionException.java","0","0","0","0","0"
"1","UndefinedPartitionKeyException.java","24737","27752","52489","24737","24737.0"
"1","UndefinedPartitionMethodException.java","24737","27752","52489","24737","24737.0"
"1","UndefinedTableException.java","83983","380705","464688","83983","83983.0"
"1","UndefinedTablespaceException.java","83983","380705","464688","83983","83983.0"
"1","UndefinedTablespaceHandlerException.java","0","0","0","0","0"
"1","UnknownDataFormatException.java","84062","386860","470922","84062","84062.0"
"1","UnremovableTablePropertyException.java","0","0","0","0","0"
"1","UnsupportedCatalogStore.java","0","0","0","0","0"
"1","UnsupportedDataTypeException.java","84208","389145","473353","84208","84208.0"
"1","UnsupportedException.java","0","0","0","0","0"
"1","ValueOutOfRangeException.java","0","0","0","0","0"
"1","ValueTooLongForTypeCharactersException.java","0","0","0","0","0"
"1","ExecutionBlockId.java","0","0","0","0","0"
"1","HAConstants.java","0","0","0","0","0"
"1","ClassNameSerializer.java","82548","281343","363891","82548","82548.0"
"1","CommonGsonHelper.java","0","0","0","0","0"
"1","DataTypeAdapter.java","0","0","0","0","0"
"1","DatumAdapter.java","48415","106907","155322","48415","48415.0"
"1","GsonHelper.java","0","0","0","0","0"
"1","GsonObject.java","0","0","0","0","0"
"1","GsonSerDerAdapter.java","0","0","0","0","0"
"1","PathSerializer.java","0","0","0","0","0"
"1","TimeZoneGsonSerdeAdapter.java","0","0","0","0","0"
"1","TypeAdapter.java","0","0","0","0","0"
"1","OverridableConf.java","463","3653","4116","463","463.0"
"1","QueryId.java","80935","376785","457720","80935","80935.0"
"1","QueryIdFactory.java","79968","304550","384518","79968","79968.0"
"1","QueryVars.java","0","0","0","0","0"
"1","BaseRuleProvider.java","0","0","0","0","0"
"1","CheckHadoopRuntimeVersionRule.java","0","0","0","0","0"
"1","TajoConfValidationRule.java","0","0","0","0","0"
"1","EvaluationContext.java","0","0","0","0","0"
"1","EvaluationFailedException.java","0","0","0","0","0"
"1","EvaluationResult.java","0","0","0","0","0"
"1","SelfDiagnosisRule.java","0","0","0","0","0"
"1","SelfDiagnosisRuleDefinition.java","0","0","0","0","0"
"1","SelfDiagnosisRuleEngine.java","12","123","135","12","12.0"
"1","SelfDiagnosisRuleProvider.java","0","0","0","0","0"
"1","SelfDiagnosisRuleSession.java","53844","69782","123626","53844","53844.0"
"1","SelfDiagnosisRuleVisibility.java","0","0","0","0","0"
"1","ANSISQLIdentifierPolicy.java","0","0","0","0","0"
"1","Field.java","0","0","0","0","0"
"1","Identifier.java","0","0","0","0","0"
"1","IdentifierPolicy.java","0","0","0","0","0"
"1","IdentifierUtil.java","0","0","0","0","0"
"1","package-info.java","0","0","0","0","0"
"1","PgSQLIdentifierPolicy.java","0","0","0","0","0"
"1","QualifiedIdentifier.java","0","0","0","0","0"
"1","Schema.java","50436","118362","168798","50436","50436.0"
"1","TajoIdentifierPolicy.java","0","0","0","0","0"
"1","BaseServiceTracker.java","19961","43005","62966","19961","19961.0"
"1","HAServiceTracker.java","19961","43005","62966","19961","19961.0"
"1","ServiceTracker.java","81690","172148","253838","81690","81690.0"
"1","ServiceTrackerException.java","0","0","0","0","0"
"1","ServiceTrackerFactory.java","0","0","0","0","0"
"1","TajoMasterInfo.java","0","0","0","0","0"
"1","SessionVars.java","35320","98866","134186","35320","35320.0"
"1","BufferPool.java","66502","110968","177470","66502","66502.0"
"1","EmptyTuple.java","78262","166673","244935","78262","78262.0"
"1","NullTuple.java","13886","55100","68986","13886","13886.0"
"1","StorageConstants.java","127970","223608","351578","127970","127970.0"
"1","Tuple.java","51302","121398","172700","51302","51302.0"
"1","VTuple.java","51302","121398","172700","51302","51302.0"
"1","TajoConstants.java","59686","132242","191928","59686","59686.0"
"1","TaskAttemptId.java","79968","304550","384518","79968","79968.0"
"1","TaskId.java","79968","304550","384518","79968","79968.0"
"1","BaseTupleBuilder.java","7397","11849","19246","7397","7397.0"
"1","CompactRowBlockWriter.java","1906","2605","4511","1906","1906.0"
"1","DirectBufTuple.java","120694","228204","348898","120694","120694.0"
"1","FixedSizeLimitSpec.java","0","0","0","0","0"
"1","HeapRowBlockReader.java","0","0","0","0","0"
"1","HeapTuple.java","76797","166919","243716","76797","76797.0"
"1","MemoryBlock.java","0","0","0","0","0"
"1","MemoryRowBlock.java","13995","43228","57223","13995","13995.0"
"1","OffHeapRowBlockReader.java","0","0","0","0","0"
"1","OffHeapRowBlockUtils.java","13995","43228","57223","13995","13995.0"
"1","OffHeapRowBlockWriter.java","120694","228204","348898","120694","120694.0"
"1","OffHeapRowWriter.java","0","0","0","0","0"
"1","ResizableLimitSpec.java","127071","263814","390885","127071","127071.0"
"1","ResizableMemoryBlock.java","15702","45634","61336","15702","15702.0"
"1","RowBlock.java","13995","43228","57223","13995","13995.0"
"1","RowWriter.java","120694","228204","348898","120694","120694.0"
"1","UnSafeTuple.java","1712","9416","11128","1712","1712.0"
"1","UnSafeTupleBytesComparator.java","0","0","0","0","0"
"1","UnSafeTupleList.java","0","0","0","0","0"
"1","ZeroCopyTuple.java","0","0","0","0","0"
"1","RowBlockReader.java","0","0","0","0","0"
"1","TupleBuilder.java","0","0","0","0","0"
"1","Any.java","0","0","0","0","0"
"1","Array.java","0","0","0","0","0"
"1","Bit.java","0","0","0","0","0"
"1","Blob.java","0","0","0","0","0"
"1","Bool.java","0","0","0","0","0"
"1","Char.java","0","0","0","0","0"
"1","Date.java","50514","119658","170172","50514","50514.0"
"1","Float4.java","0","0","0","0","0"
"1","Float8.java","0","0","0","0","0"
"1","Int1.java","0","0","0","0","0"
"1","Int2.java","0","0","0","0","0"
"1","Int4.java","0","0","0","0","0"
"1","Int8.java","0","0","0","0","0"
"1","Interval.java","0","0","0","0","0"
"1","Map.java","0","0","0","0","0"
"1","Null.java","0","0","0","0","0"
"1","Numeric.java","0","0","0","0","0"
"1","package-info.java","0","0","0","0","0"
"1","Protobuf.java","0","0","0","0","0"
"1","Record.java","0","0","0","0","0"
"1","Text.java","0","0","0","0","0"
"1","Time.java","0","0","0","0","0"
"1","Timestamp.java","0","0","0","0","0"
"1","Type.java","0","0","0","0","0"
"1","TypeFactory.java","0","0","0","0","0"
"1","TypeParamterizedType.java","0","0","0","0","0"
"1","TypeProtobufEncoder.java","0","0","0","0","0"
"1","TypeStringEncoder.java","0","0","0","0","0"
"1","TypeVisitor.java","0","0","0","0","0"
"1","ValueParamterizedType.java","0","0","0","0","0"
"1","Varchar.java","0","0","0","0","0"
"1","StorageUnit.java","0","0","0","0","0"
"1","TimeUnit.java","0","0","0","0","0"
"1","BasicFuture.java","0","0","0","0","0"
"1","BitArray.java","0","0","0","0","0"
"1","Bytes.java","60372","134878","195250","60372","60372.0"
"1","BytesUtils.java","738","3266","4004","738","738.0"
"1","ClassSize.java","0","0","0","0","0"
"1","ClassUtil.java","129084","258735","387819","129084","129084.0"
"1","CommonTestingUtil.java","59834","133461","193295","59834","59834.0"
"1","CompressionUtil.java","0","0","0","0","0"
"1","DateTimeConstants.java","44074","133165","177239","44074","44074.0"
"1","DateTimeFormat.java","5779","8637","14416","5779","5779.0"
"1","DateTimeUtil.java","984","4434","5418","984","984.0"
"1","TimeMeta.java","80714","193536","274250","80714","80714.0"
"1","Deallocatable.java","0","0","0","0","0"
"1","FileUtil.java","59686","132242","191928","59686","59686.0"
"1","DirectedGraph.java","32025","84170","116195","32025","32025.0"
"1","DirectedGraphCursor.java","0","0","0","0","0"
"1","DirectedGraphVisitor.java","0","0","0","0","0"
"1","Graph.java","0","0","0","0","0"
"1","SimpleDirectedGraph.java","32025","84170","116195","32025","32025.0"
"1","SimpleUndirectedGraph.java","29277","69439","98716","29277","29277.0"
"1","UndirectedGraph.java","0","0","0","0","0"
"1","JarUtil.java","0","0","0","0","0"
"1","JavaResourceUtil.java","0","0","0","0","0"
"1","KeyValueSet.java","60663","137490","198153","60663","60663.0"
"1","MurmurHash.java","0","0","0","0","0"
"1","NetUtils.java","0","0","0","0","0"
"1","NumberUtil.java","88828","210463","299291","88828","88828.0"
"1","Pair.java","116384","167968","284352","116384","116384.0"
"1","PlatformUtil.java","0","0","0","0","0"
"1","ProtoUtil.java","128534","252668","381202","128534","128534.0"
"1","ReflectionUtil.java","82701","309764","392465","82701","82701.0"
"1","ShutdownHookManager.java","0","0","0","0","0"
"1","SizeOf.java","0","0","0","0","0"
"1","StringUtils.java","116144","120404","236548","116144","116144.0"
"1","TajoIdUtils.java","49312","109844","159156","49312","49312.0"
"1","TUtil.java","60889","142568","203457","60889","60889.0"
"1","UnsafeComparer.java","0","0","0","0","0"
"1","UnsafeUtil.java","66053","114702","180755","66053","66053.0"
"1","UriUtil.java","0","0","0","0","0"
"1","VersionInfo.java","42415","134981","177396","42415","42415.0"
"1","AbstractValidator.java","0","0","0","0","0"
"1","BooleanValidator.java","0","0","0","0","0"
"1","ClassValidator.java","0","0","0","0","0"
"1","ConstraintViolation.java","0","0","0","0","0"
"1","ConstraintViolationException.java","53584","85811","139395","53584","53584.0"
"1","GroupValidator.java","0","0","0","0","0"
"1","JavaStringValidator.java","0","0","0","0","0"
"1","LengthValidator.java","0","0","0","0","0"
"1","MaxValidator.java","0","0","0","0","0"
"1","MinValidator.java","0","0","0","0","0"
"1","NetworkAddressValidator.java","0","0","0","0","0"
"1","NotNullValidator.java","0","0","0","0","0"
"1","PathListValidator.java","0","0","0","0","0"
"1","PathValidator.java","0","0","0","0","0"
"1","PatternValidator.java","0","0","0","0","0"
"1","RangeValidator.java","0","0","0","0","0"
"1","ShellVariableValidator.java","0","0","0","0","0"
"1","Validator.java","0","0","0","0","0"
"1","Validators.java","12862","29262","42124","12862","12862.0"
"1","TestIPv4.java","0","0","0","0","0"
"1","TestTimeRange.java","0","0","0","0","0"
"1","TestProtobufDatum.java","0","0","0","0","0"
"1","TestTextUtils.java","0","0","0","0","0"
"1","TestArithmeticOperator.java","0","0","0","0","0"
"1","TestBitDatum.java","50436","118362","168798","50436","50436.0"
"1","TestBoolDatum.java","48415","106732","155147","48415","48415.0"
"1","TestBytesDatum.java","0","0","0","0","0"
"1","TestCharDatum.java","0","0","0","0","0"
"1","TestDateDatum.java","50635","87739","138374","50635","50635.0"
"1","TestDatum.java","0","0","0","0","0"
"1","TestDatumFactory.java","0","0","0","0","0"
"1","TestFloat8Datum.java","0","0","0","0","0"
"1","TestFloatDatum.java","0","0","0","0","0"
"1","TestInt2Datum.java","0","0","0","0","0"
"1","TestInt4Datum.java","0","0","0","0","0"
"1","TestInt8Datum.java","0","0","0","0","0"
"1","TestIntervalDatum.java","2925","16860","19785","2925","2925.0"
"1","TestTextDatum.java","82346","218529","300875","82346","82346.0"
"1","TestTimeDatum.java","10629","17073","27702","10629","10629.0"
"1","TestTimestampDatum.java","857","1939","2796","857","857.0"
"1","TestRuleEngine.java","0","0","0","0","0"
"1","TestRuleSession.java","0","0","0","0","0"
"1","TestANSISQLIdentifierPolicy.java","0","0","0","0","0"
"1","TestIdentifier.java","0","0","0","0","0"
"1","TestSchema.java","47541","105513","153054","47541","47541.0"
"1","TestTajoIdentifierPolicy.java","0","0","0","0","0"
"1","TestHeapTuple.java","0","0","0","0","0"
"1","TestMemoryRowBlock.java","120694","228204","348898","120694","120694.0"
"1","TestResizableSpec.java","0","0","0","0","0"
"1","TestUnSafeTupleBytesComparator.java","0","0","0","0","0"
"1","TestBaseTupleBuilder.java","0","0","0","0","0"
"1","TestType.java","0","0","0","0","0"
"1","TestTypeEncoder.java","0","0","0","0","0"
"1","TestTypeProtobufEncoder.java","0","0","0","0","0"
"1","TestTypeStringEncoder.java","0","0","0","0","0"
"1","TestSimpleDirectedGraph.java","90841","275983","366824","90841","90841.0"
"1","TestSimpleUndirectedGraph.java","99626","272785","372411","99626","99626.0"
"1","TestBitArrayTest.java","0","0","0","0","0"
"1","TestDateTimeFormat.java","0","0","0","0","0"
"1","TestDateTimeUtil.java","44074","133165","177239","44074","44074.0"
"1","TestNumberUtil.java","0","0","0","0","0"
"1","TestStringUtil.java","0","0","0","0","0"
"1","TestUriUtil.java","0","0","0","0","0"
"1","TestValidators.java","12862","29262","42124","12862","12862.0"
"1","BenchmarkSet.java","82709","311328","394037","82709","82709.0"
"1","Driver.java","0","0","0","0","0"
"1","SimpleQuery.java","0","0","0","0","0"
"1","TPCH.java","47339","96431","143770","47339","47339.0"
"1","CaseWhenEmitter.java","3456","13152","16608","3456","3456.0"
"1","CaseWhenSwitchGenerator.java","0","0","0","0","0"
"1","CodeGenUtils.java","0","0","0","0","0"
"1","CompilationError.java","90651","268645","359296","90651","90651.0"
"1","EvalCodeEmitter.java","0","0","0","0","0"
"1","EvalCodeGenContext.java","0","0","0","0","0"
"1","EvalCodeGenerator.java","3456","13152","16608","3456","3456.0"
"1","ExecutorPreCompiler.java","34831","41979","76810","34831","34831.0"
"1","LegacyFunctionBindingEmitter.java","0","0","0","0","0"
"1","ScalarFunctionBindingEmitter.java","0","0","0","0","0"
"1","TajoClassLoader.java","90651","268645","359296","90651","90651.0"
"1","TajoGeneratorAdapter.java","3456","13152","16608","3456","3456.0"
"1","VariablesPreBuilder.java","0","0","0","0","0"
"1","RangeOverflowException.java","82324","215856","298180","82324","82324.0"
"1","Description.java","0","0","0","0","0"
"1","ParamOptionTypes.java","0","0","0","0","0"
"1","ParamTypes.java","0","0","0","0","0"
"1","AvgDouble.java","82704","312460","395164","82704","82704.0"
"1","AvgFloat.java","50514","119658","170172","50514","50514.0"
"1","AvgInt.java","50514","119658","170172","50514","50514.0"
"1","AvgLong.java","82704","312460","395164","82704","82704.0"
"1","Coalesce.java","0","0","0","0","0"
"1","CoalesceBoolean.java","0","0","0","0","0"
"1","CoalesceDate.java","0","0","0","0","0"
"1","CoalesceDouble.java","0","0","0","0","0"
"1","CoalesceLong.java","0","0","0","0","0"
"1","CoalesceString.java","0","0","0","0","0"
"1","CoalesceTime.java","0","0","0","0","0"
"1","CoalesceTimestamp.java","0","0","0","0","0"
"1","Corr.java","0","0","0","0","0"
"1","CountRows.java","0","0","0","0","0"
"1","CountValue.java","0","0","0","0","0"
"1","CountValueDistinct.java","32119","89056","121175","32119","32119.0"
"1","Date.java","50514","119658","170172","50514","50514.0"
"1","LastValue.java","0","0","0","0","0"
"1","LastValueDate.java","0","0","0","0","0"
"1","LastValueDouble.java","0","0","0","0","0"
"1","LastValueFloat.java","0","0","0","0","0"
"1","LastValueInt.java","0","0","0","0","0"
"1","LastValueLong.java","0","0","0","0","0"
"1","LastValueString.java","0","0","0","0","0"
"1","LastValueTime.java","0","0","0","0","0"
"1","LastValueTimestamp.java","0","0","0","0","0"
"1","Lead.java","100026","202719","302745","100026","100026.0"
"1","LeadDate.java","0","0","0","0","0"
"1","LeadDouble.java","0","0","0","0","0"
"1","LeadFloat.java","0","0","0","0","0"
"1","LeadInt.java","0","0","0","0","0"
"1","LeadLong.java","0","0","0","0","0"
"1","LeadString.java","0","0","0","0","0"
"1","LeadTime.java","0","0","0","0","0"
"1","LeadTimestamp.java","0","0","0","0","0"
"1","Max.java","0","0","0","0","0"
"1","MaxDate.java","0","0","0","0","0"
"1","MaxDouble.java","50514","119658","170172","50514","50514.0"
"1","MaxFloat.java","50514","119658","170172","50514","50514.0"
"1","MaxInt.java","50514","119658","170172","50514","50514.0"
"1","MaxLong.java","50514","119658","170172","50514","50514.0"
"1","MaxString.java","131661","290357","422018","131661","131661.0"
"1","MaxTime.java","0","0","0","0","0"
"1","MaxTimestamp.java","0","0","0","0","0"
"1","Min.java","0","0","0","0","0"
"1","MinDate.java","0","0","0","0","0"
"1","MinDouble.java","50514","119658","170172","50514","50514.0"
"1","MinFloat.java","50514","119658","170172","50514","50514.0"
"1","MinInt.java","50514","119658","170172","50514","50514.0"
"1","MinLong.java","50514","119658","170172","50514","50514.0"
"1","MinString.java","50514","119658","170172","50514","50514.0"
"1","MinTime.java","0","0","0","0","0"
"1","MinTimestamp.java","0","0","0","0","0"
"1","RandomInt.java","50514","119658","170172","50514","50514.0"
"1","Sleep.java","0","0","0","0","0"
"1","StdDevPop.java","7313","12999","20312","7313","7313.0"
"1","StdDevPopDouble.java","0","0","0","0","0"
"1","StdDevPopFloat.java","0","0","0","0","0"
"1","StdDevPopInt.java","0","0","0","0","0"
"1","StdDevPopLong.java","0","0","0","0","0"
"1","StdDevSamp.java","7313","12999","20312","7313","7313.0"
"1","StdDevSampDouble.java","0","0","0","0","0"
"1","StdDevSampFloat.java","0","0","0","0","0"
"1","StdDevSampInt.java","0","0","0","0","0"
"1","StdDevSampLong.java","0","0","0","0","0"
"1","StringAgg.java","0","0","0","0","0"
"1","SumDouble.java","82704","312460","395164","82704","82704.0"
"1","SumDoubleDistinct.java","0","0","0","0","0"
"1","SumFloat.java","50514","119658","170172","50514","50514.0"
"1","SumFloatDistinct.java","0","0","0","0","0"
"1","SumInt.java","50514","119658","170172","50514","50514.0"
"1","SumIntDistinct.java","0","0","0","0","0"
"1","SumLong.java","82704","312460","395164","82704","82704.0"
"1","SumLongDistinct.java","0","0","0","0","0"
"1","Variance.java","0","0","0","0","0"
"1","VarPop.java","0","0","0","0","0"
"1","VarPopDouble.java","0","0","0","0","0"
"1","VarPopFloat.java","0","0","0","0","0"
"1","VarPopInt.java","0","0","0","0","0"
"1","VarPopLong.java","0","0","0","0","0"
"1","VarSamp.java","0","0","0","0","0"
"1","VarSampDouble.java","0","0","0","0","0"
"1","VarSampFloat.java","0","0","0","0","0"
"1","VarSampInt.java","0","0","0","0","0"
"1","VarSampLong.java","0","0","0","0","0"
"1","AddDays.java","0","0","0","0","0"
"1","AddMonths.java","0","0","0","0","0"
"1","CurrentDate.java","47420","138991","186411","47420","47420.0"
"1","CurrentTime.java","82129","203040","285169","82129","82129.0"
"1","DatePartFromDate.java","136406","358031","494437","136406","136406.0"
"1","DatePartFromTime.java","128837","176295","305132","128837","128837.0"
"1","DatePartFromTimestamp.java","128837","176295","305132","128837","128837.0"
"1","DateTimePartFromUnixTimestamp.java","115250","143880","259130","115250","115250.0"
"1","NowTimestamp.java","50514","119658","170172","50514","50514.0"
"1","ToCharTimestamp.java","17944","35216","53160","17944","17944.0"
"1","ToDate.java","2925","16860","19785","2925","2925.0"
"1","ToTimestampInt.java","17944","35216","53160","17944","17944.0"
"1","ToTimestampText.java","47149","141430","188579","47149","47149.0"
"1","FailFunction.java","0","0","0","0","0"
"1","FunctionLoader.java","92487","142115","234602","92487","92487.0"
"1","BlobToIPstr.java","0","0","0","0","0"
"1","GeoIPCountryBlob.java","0","0","0","0","0"
"1","GeoIPCountryInt.java","0","0","0","0","0"
"1","GeoIPCountryText.java","0","0","0","0","0"
"1","GeoIPInCountryBlob.java","0","0","0","0","0"
"1","GeoIPInCountryInt.java","0","0","0","0","0"
"1","GeoIPInCountryText.java","144213","354057","498270","144213","144213.0"
"1","IntToIPstr.java","0","0","0","0","0"
"1","IPstrToBlob.java","0","0","0","0","0"
"1","IPstrToInt.java","0","0","0","0","0"
"1","HiveFunctionLoader.java","0","0","0","0","0"
"1","JsonArrayContains.java","0","0","0","0","0"
"1","JsonArrayGet.java","0","0","0","0","0"
"1","JsonArrayLength.java","0","0","0","0","0"
"1","JsonExtractPathText.java","0","0","0","0","0"
"1","ScalarJsonFunction.java","0","0","0","0","0"
"1","AbsDouble.java","0","0","0","0","0"
"1","AbsFloat.java","0","0","0","0","0"
"1","AbsInt.java","0","0","0","0","0"
"1","AbsLong.java","0","0","0","0","0"
"1","Acos.java","0","0","0","0","0"
"1","Asin.java","0","0","0","0","0"
"1","Atan.java","0","0","0","0","0"
"1","Atan2.java","0","0","0","0","0"
"1","Cbrt.java","0","0","0","0","0"
"1","Ceil.java","17870","42511","60381","17870","17870.0"
"1","Cos.java","0","0","0","0","0"
"1","Degrees.java","0","0","0","0","0"
"1","Div.java","122913","366311","489224","122913","122913.0"
"1","Exp.java","0","0","0","0","0"
"1","Floor.java","0","0","0","0","0"
"1","MathFunctions.java","0","0","0","0","0"
"1","Mod.java","122913","366311","489224","122913","122913.0"
"1","Pi.java","0","0","0","0","0"
"1","Pow.java","0","0","0","0","0"
"1","Radians.java","0","0","0","0","0"
"1","Round.java","1584","7072","8656","1584","1584.0"
"1","RoundFloat8.java","9275","33794","43069","9275","9275.0"
"1","Sign.java","0","0","0","0","0"
"1","Sin.java","0","0","0","0","0"
"1","Sqrt.java","0","0","0","0","0"
"1","Tan.java","0","0","0","0","0"
"1","Ascii.java","122457","366311","488768","122457","122457.0"
"1","BitLength.java","118277","366469","484746","118277","118277.0"
"1","BTrim.java","31717","77032","108749","31717","31717.0"
"1","CharLength.java","113915","369562","483477","113915","113915.0"
"1","Chr.java","125108","366188","491296","125108","125108.0"
"1","Concat.java","115885","154502","270387","115885","115885.0"
"1","Concat_ws.java","115974","154502","270476","115974","115974.0"
"1","Decode.java","130820","365207","496027","130820","130820.0"
"1","Digest.java","134921","358041","492962","134921","134921.0"
"1","Encode.java","130820","365207","496027","130820","130820.0"
"1","FindInSet.java","130842","364340","495182","130842","130842.0"
"1","HexStringConverter.java","0","0","0","0","0"
"1","InitCap.java","121911","366311","488222","121911","121911.0"
"1","Left.java","119990","366462","486452","119990","119990.0"
"1","Length.java","0","0","0","0","0"
"1","Locate.java","123701","366301","490002","123701","123701.0"
"1","Lower.java","0","0","0","0","0"
"1","Lpad.java","18071","38547","56618","18071","18071.0"
"1","LTrim.java","31717","77032","108749","31717","31717.0"
"1","Md5.java","118960","366467","485427","118960","118960.0"
"1","OctetLength.java","0","0","0","0","0"
"1","QuoteIdent.java","0","0","0","0","0"
"1","RegexpReplace.java","31394","87826","119220","31394","31394.0"
"1","Repeat.java","120224","366462","486686","120224","120224.0"
"1","Reverse.java","118885","366467","485352","118885","118885.0"
"1","Right.java","119990","366462","486452","119990","119990.0"
"1","Rpad.java","18078","38460","56538","18078","18078.0"
"1","RTrim.java","31717","77032","108749","31717","31717.0"
"1","SplitPart.java","33508","90619","124127","33508","33508.0"
"1","StrPos.java","118818","366467","485285","118818","118818.0"
"1","StrPosb.java","118818","366467","485285","118818","118818.0"
"1","Substr.java","1521","7399","8920","1521","1521.0"
"1","ToBin.java","0","0","0","0","0"
"1","ToCharLong.java","0","0","0","0","0"
"1","ToHex.java","17909","42094","60003","17909","17909.0"
"1","Upper.java","101185","370152","471337","101185","101185.0"
"1","FirstValue.java","49946","118111","168057","49946","49946.0"
"1","FirstValueDate.java","0","0","0","0","0"
"1","FirstValueDouble.java","0","0","0","0","0"
"1","FirstValueFloat.java","0","0","0","0","0"
"1","FirstValueInt.java","0","0","0","0","0"
"1","FirstValueLong.java","0","0","0","0","0"
"1","FirstValueString.java","0","0","0","0","0"
"1","FirstValueTime.java","0","0","0","0","0"
"1","FirstValueTimestamp.java","0","0","0","0","0"
"1","Lag.java","34400","96788","131188","34400","34400.0"
"1","LagDate.java","0","0","0","0","0"
"1","LagDouble.java","0","0","0","0","0"
"1","LagFloat.java","0","0","0","0","0"
"1","LagInt.java","0","0","0","0","0"
"1","LagLong.java","0","0","0","0","0"
"1","LagString.java","0","0","0","0","0"
"1","LagTime.java","0","0","0","0","0"
"1","LagTimestamp.java","0","0","0","0","0"
"1","Rank.java","0","0","0","0","0"
"1","RowNumber.java","0","0","0","0","0"
"1","CoreGsonHelper.java","74191","277263","351454","74191","74191.0"
"1","Enforcer.java","45113","105127","150240","45113","45113.0"
"1","DistinctGroupbyBuilder.java","89","615","704","89","89.0"
"1","DataChannel.java","27762","74334","102096","27762","27762.0"
"1","ExecutionBlock.java","47541","105513","153054","47541","47541.0"
"1","ExecutionBlockCursor.java","82121","209497","291618","82121","82121.0"
"1","ExecutionQueue.java","0","0","0","0","0"
"1","GlobalPlanner.java","47339","96431","143770","47339","47339.0"
"1","MasterPlan.java","24811","57332","82143","32311","32311.0"
"1","ParallelExecutionQueue.java","127186","171988","299174","127186","127186.0"
"1","BaseGlobalPlanRewriteRuleProvider.java","47050","111962","159012","47050","47050.0"
"1","GlobalPlanRewriteEngine.java","110986","221786","332772","110986","110986.0"
"1","GlobalPlanRewriteRule.java","0","0","0","0","0"
"1","GlobalPlanRewriteRuleProvider.java","0","0","0","0","0"
"1","GlobalPlanTestRuleProvider.java","0","0","0","0","0"
"1","BroadcastJoinRule.java","116525","133066","249591","116525","116525.0"
"1","GlobalPlanEqualityTester.java","0","0","0","0","0"
"1","GlobalPlanRewriteUtil.java","0","0","0","0","0"
"1","KeyProjector.java","0","0","0","0","0"
"1","AggregationExec.java","51141","121619","172760","51141","51141.0"
"1","BasicPhysicalExecutorVisitor.java","33977","90798","124775","33977","33977.0"
"1","BinaryPhysicalExec.java","0","0","0","0","0"
"1","BSTIndexScanExec.java","60532","135764","196296","60532","60532.0"
"1","ColPartitionStoreExec.java","110071","165762","275833","110071","110071.0"
"1","CommonHashJoinExec.java","31147","77687","108834","31147","31147.0"
"1","CommonJoinExec.java","10213","23123","33336","10213","10213.0"
"1","ComparableVector.java","1299","6754","8053","1299","1299.0"
"1","DistinctGroupbyFirstAggregationExec.java","72906","104182","177088","72906","72906.0"
"1","DistinctGroupbyHashAggregationExec.java","89","615","704","89","89.0"
"1","DistinctGroupbySecondAggregationExec.java","111591","213498","325089","111591","111591.0"
"1","DistinctGroupbySortAggregationExec.java","2015","12521","14536","2015","2015.0"
"1","DistinctGroupbyThirdAggregationExec.java","84390","120082","204472","84390","84390.0"
"1","EmptyScanIterator.java","0","0","0","0","0"
"1","EvalExprExec.java","60888","140564","201452","60888","60888.0"
"1","ExternalSortExec.java","59834","133461","193295","59834","59834.0"
"1","FilterScanIterator.java","0","0","0","0","0"
"1","FullScanIterator.java","0","0","0","0","0"
"1","HashAggregateExec.java","50436","118362","168798","50436","50436.0"
"1","HashBasedColPartitionStoreExec.java","137127","363311","500438","137127","137127.0"
"1","HashFullOuterJoinExec.java","33765","87138","120903","33765","33765.0"
"1","HashJoinExec.java","83580","334734","418314","83580","83580.0"
"1","HashLeftAntiJoinExec.java","79733","332674","412407","79733","79733.0"
"1","HashLeftOuterJoinExec.java","96620","313018","409638","96620","96620.0"
"1","HashLeftSemiJoinExec.java","78666","269231","347897","78666","78666.0"
"1","HashPartitioner.java","49672","111858","161530","49672","49672.0"
"1","HashShuffleFileWriteExec.java","49672","111858","161530","49672","49672.0"
"1","HavingExec.java","132757","303075","435832","132757","132757.0"
"1","IndexExecutorUtil.java","0","0","0","0","0"
"1","InsertRowsExec.java","0","0","0","0","0"
"1","JoinTupleComparator.java","0","0","0","0","0"
"1","KeyTuple.java","2685","2841","5526","2685","2685.0"
"1","LimitExec.java","0","0","0","0","0"
"1","MergeFullOuterJoinExec.java","47745","108430","156175","47745","47745.0"
"1","MergeJoinExec.java","83604","321848","405452","83604","83604.0"
"1","Partitioner.java","49672","111858","161530","49672","49672.0"
"1","PartitionMergeScanExec.java","10783","16349","27132","10783","10783.0"
"1","PhysicalExec.java","47541","105513","153054","47541","47541.0"
"1","PhysicalExecutorVisitor.java","0","0","0","0","0"
"1","PhysicalPlanUtil.java","33977","90798","124775","33977","33977.0"
"1","ProjectionExec.java","0","0","0","0","0"
"1","RadixSort.java","0","0","0","0","0"
"1","RangeShuffleFileWriteExec.java","49672","111858","161530","49672","49672.0"
"1","RightOuterMergeJoinExec.java","47050","105177","152227","47050","47050.0"
"1","ScanExec.java","0","0","0","0","0"
"1","ScanIterator.java","0","0","0","0","0"
"1","SelectionExec.java","82390","271489","353879","82390","82390.0"
"1","SeqScanExec.java","47541","105513","153054","47541","47541.0"
"1","SetTupleComparator.java","0","0","0","0","0"
"1","SortAggregateExec.java","51141","121619","172760","51141","51141.0"
"1","SortBasedColPartitionStoreExec.java","2745","7119","9864","2745","2745.0"
"1","SortExec.java","83603","320421","404024","83603","83603.0"
"1","SortIntersectExec.java","0","0","0","0","0"
"1","StoreIndexExec.java","99780","108724","208504","99780","99780.0"
"1","StoreTableExec.java","49672","111858","161530","49672","49672.0"
"1","TunnelExec.java","0","0","0","0","0"
"1","TupleList.java","0","0","0","0","0"
"1","TupleMap.java","0","0","0","0","0"
"1","TupleSet.java","0","0","0","0","0"
"1","TupleSorter.java","2320","3992","6312","2320","2320.0"
"1","UnaryPhysicalExec.java","60372","134470","194842","60372","60372.0"
"1","UnionExec.java","0","0","0","0","0"
"1","VectorizedSorter.java","2320","3992","6312","2320","2320.0"
"1","WindowAggExec.java","35808","106404","142212","35808","35808.0"
"1","PhysicalPlanner.java","0","0","0","0","0"
"1","PhysicalPlannerImpl.java","47339","96431","143770","47339","47339.0"
"1","PhysicalPlanningException.java","0","0","0","0","0"
"1","Projector.java","50436","118362","168798","50436","50436.0"
"1","RangePartitionAlgorithm.java","50436","118362","168798","50436","50436.0"
"1","UniformRangePartition.java","60372","134470","194842","60372","60372.0"
"1","QueryContext.java","27670","86208","113878","27670","27670.0"
"1","TaskRequest.java","0","0","0","0","0"
"1","TaskRequestImpl.java","81830","186459","268289","81830","81830.0"
"1","CacheHolder.java","15320","32971","48291","15320","15320.0"
"1","TableCache.java","0","0","0","0","0"
"1","TableCacheKey.java","148834","282336","431170","148834","148834.0"
"1","ErrorInjectionRewriter.java","0","0","0","0","0"
"1","TupleUtil.java","60890","142763","203653","60890","60890.0"
"1","HdfsServiceTracker.java","5381","8241","13622","5381","5381.0"
"1","AsyncTaskService.java","0","0","0","0","0"
"1","WorkerConnectionInfo.java","0","0","0","0","0"
"1","FragmentScheduleEvent.java","44152","80107","124259","44152","44152.0"
"1","LocalTaskEvent.java","140321","359411","499732","140321","140321.0"
"1","LocalTaskEventType.java","0","0","0","0","0"
"1","QueryCompletedEvent.java","0","0","0","0","0"
"1","QueryDiagnosticsUpdateEvent.java","0","0","0","0","0"
"1","QueryEvent.java","0","0","0","0","0"
"1","QueryEventType.java","0","0","0","0","0"
"1","QueryMasterQueryCompletedEvent.java","0","0","0","0","0"
"1","QueryStartEvent.java","46725","136412","183137","46725","46725.0"
"1","QueryStopEvent.java","108386","212992","321378","108386","108386.0"
"1","StageCompletedEvent.java","82703","307090","389793","82703","82703.0"
"1","StageDiagnosticsUpdateEvent.java","120736","295584","416320","120736","120736.0"
"1","StageEvent.java","82703","307090","389793","82703","82703.0"
"1","StageEventType.java","47350","96889","144239","47350","47350.0"
"1","StageShuffleReportEvent.java","0","0","0","0","0"
"1","StageTaskEvent.java","60621","136457","197078","60621","60621.0"
"1","StageTaskFailedEvent.java","0","0","0","0","0"
"1","TaskAttemptAssignedEvent.java","82390","272971","355361","82390","82390.0"
"1","TaskAttemptEvent.java","0","0","0","0","0"
"1","TaskAttemptEventType.java","60621","136457","197078","60621","60621.0"
"1","TaskAttemptScheduleEvent.java","0","0","0","0","0"
"1","TaskAttemptStatusUpdateEvent.java","0","0","0","0","0"
"1","TaskAttemptToSchedulerEvent.java","0","0","0","0","0"
"1","TaskCompletionEvent.java","0","0","0","0","0"
"1","TaskEvent.java","0","0","0","0","0"
"1","TaskEventType.java","0","0","0","0","0"
"1","TaskFatalErrorEvent.java","47415","100369","147784","47415","47415.0"
"1","TaskRequestEvent.java","0","0","0","0","0"
"1","TaskSchedulerEvent.java","0","0","0","0","0"
"1","TaskTAttemptEvent.java","82703","306590","389293","82703","82703.0"
"1","TaskTAttemptFailedEvent.java","0","0","0","0","0"
"1","CreateTableExecutor.java","3861","7590","11451","3861","3861.0"
"1","DDLExecutor.java","31951","46704","78655","31951","31951.0"
"1","ExplainGlobalPlanPreprocessorForTest.java","0","0","0","0","0"
"1","ExplainPlanPreprocessorForTest.java","20936","71145","92081","20936","20936.0"
"1","NonForwardQueryResultFileScanner.java","29489","43630","73119","29489","29489.0"
"1","NonForwardQueryResultScanner.java","73047","111147","184194","73047","73047.0"
"1","NonForwardQueryResultSystemScanner.java","21579","23334","44913","21579","21579.0"
"1","CreateTableHook.java","54138","126057","180195","54138","54138.0"
"1","DistributedQueryHook.java","0","0","0","0","0"
"1","DistributedQueryHookManager.java","0","0","0","0","0"
"1","InsertIntoHook.java","0","0","0","0","0"
"1","QueryExecutor.java","5093","10576","15669","5093","5093.0"
"1","GlobalEngine.java","61926","159903","221829","61926","61926.0"
"1","QueryCoordinatorService.java","27925","78017","105942","27925","27925.0"
"1","QueryInfo.java","45634","123034","168668","45634","45634.0"
"1","QueryInProgress.java","44942","121473","166415","44942","44942.0"
"1","QueryManager.java","79275","189490","268765","79275","79275.0"
"1","NodeEvent.java","142109","358708","500817","142109","142109.0"
"1","NodeEventType.java","0","0","0","0","0"
"1","NodeLivelinessMonitor.java","142109","358708","500817","142109","142109.0"
"1","NodeReconnectEvent.java","142109","358708","500817","142109","142109.0"
"1","NodeState.java","142109","358708","500817","142109","142109.0"
"1","NodeStatus.java","0","0","0","0","0"
"1","NodeStatusEvent.java","0","0","0","0","0"
"1","TajoResourceManager.java","0","0","0","0","0"
"1","TajoResourceTracker.java","140329","306888","447217","140329","140329.0"
"1","TajoRMContext.java","114181","226435","340616","114181","114181.0"
"1","WorkerResource.java","27883","74247","102130","27883","27883.0"
"1","FileSystemRule.java","0","0","0","0","0"
"1","MasterRuleProvider.java","0","0","0","0","0"
"1","AbstractQueryScheduler.java","0","0","0","0","0"
"1","ResourceReserveSchedulerEvent.java","0","0","0","0","0"
"1","SchedulerEvent.java","0","0","0","0","0"
"1","SchedulerEventType.java","0","0","0","0","0"
"1","QuerySchedulingInfo.java","99110","282161","381271","99110","99110.0"
"1","QueueInfo.java","0","0","0","0","0"
"1","QueueState.java","0","0","0","0","0"
"1","Scheduler.java","0","0","0","0","0"
"1","SchedulingAlgorithms.java","99110","282161","381271","99110","99110.0"
"1","SimpleScheduler.java","0","0","0","0","0"
"1","TajoResourceScheduler.java","0","0","0","0","0"
"1","TajoMaster.java","47417","103034","150451","47417","47417.0"
"1","TajoMasterClientService.java","47333","95906","143239","47333","47333.0"
"1","TaskState.java","0","0","0","0","0"
"1","ClusterResourceMetricSet.java","0","0","0","0","0"
"1","SQLAnalyzer.java","36097","87005","123102","36097","36097.0"
"1","SQLErrorListener.java","76524","396039","472563","76524","76524.0"
"1","SQLParseError.java","76524","396039","472563","76524","76524.0"
"1","AbstractTaskScheduler.java","48572","107052","155624","48572","48572.0"
"1","DefaultTaskScheduler.java","47541","105513","153054","47541","47541.0"
"1","FetchScheduleEvent.java","0","0","0","0","0"
"1","Query.java","46810","89962","136772","46810","46810.0"
"1","QueryJobEvent.java","44942","121473","166415","44942","44942.0"
"1","QueryMaster.java","30873","85133","116006","30873","30873.0"
"1","QueryMasterManagerService.java","11613","29348","40961","11613","11613.0"
"1","QueryMasterTask.java","28495","87162","115657","28495","28495.0"
"1","Repartitioner.java","49312","111334","160646","49312","49312.0"
"1","Stage.java","3696","8935","12631","3696","3696.0"
"1","StageState.java","60621","136457","197078","60621","60621.0"
"1","Task.java","46290","88221","134511","46290","46290.0"
"1","TaskAttempt.java","46290","88221","134511","46290","46290.0"
"1","TaskSchedulerContext.java","0","0","0","0","0"
"1","TaskSchedulerFactory.java","12804","31454","44258","12804","12804.0"
"1","DefaultResourceCalculator.java","0","0","0","0","0"
"1","NodeResource.java","0","0","0","0","0"
"1","NodeResources.java","0","0","0","0","0"
"1","ResourceCalculator.java","0","0","0","0","0"
"1","NoSuchSessionVariableException.java","83983","380705","464688","83983","83983.0"
"1","Session.java","114338","131723","246061","114338","114338.0"
"1","SessionConstants.java","0","0","0","0","0"
"1","SessionEvent.java","61564","150556","212120","61564","61564.0"
"1","SessionEventType.java","0","0","0","0","0"
"1","SessionLivelinessMonitor.java","0","0","0","0","0"
"1","SessionManager.java","116582","219214","335796","116582","116582.0"
"1","ApplicationIdUtils.java","27883","74247","102130","27883","27883.0"
"1","GeoIPUtil.java","0","0","0","0","0"
"1","History.java","0","0","0","0","0"
"1","HistoryCleaner.java","0","0","0","0","0"
"1","HistoryReader.java","36471","53136","89607","36471","36471.0"
"1","HistoryWriter.java","39364","56529","95893","39364","39364.0"
"1","QueryHistory.java","39364","56529","95893","39364","39364.0"
"1","StageHistory.java","36471","53136","89607","36471","36471.0"
"1","TaskHistory.java","41045","60189","101234","41045","41045.0"
"1","IPconvertUtil.java","0","0","0","0","0"
"1","JSPUtil.java","50729","118149","168878","50729","50729.0"
"1","JvmPauseMonitor.java","0","0","0","0","0"
"1","GroupNameMetricsFilter.java","0","0","0","0","0"
"1","LogEventGaugeSet.java","0","0","0","0","0"
"1","MetricsFilterList.java","0","0","0","0","0"
"1","RegexpMetricsFilter.java","0","0","0","0","0"
"1","GangliaReporter.java","0","0","0","0","0"
"1","MetricsConsoleReporter.java","0","0","0","0","0"
"1","MetricsConsoleScheduledReporter.java","0","0","0","0","0"
"1","MetricsFileScheduledReporter.java","0","0","0","0","0"
"1","MetricsStreamScheduledReporter.java","0","0","0","0","0"
"1","NullReporter.java","0","0","0","0","0"
"1","TajoMetricsReporter.java","129232","370379","499611","129232","129232.0"
"1","TajoMetricsScheduledReporter.java","0","0","0","0","0"
"1","TajoJMXObjectNameFactory.java","0","0","0","0","0"
"1","TajoLogEventCounter.java","0","0","0","0","0"
"1","TajoMetrics.java","129236","370559","499795","129236","129236.0"
"1","TajoSystemMetrics.java","129236","370559","499795","129236","129236.0"
"1","RpcParameterFactory.java","0","0","0","0","0"
"1","SplitUtil.java","0","0","0","0","0"
"1","TajoUncaughtExceptionHandler.java","0","0","0","0","0"
"1","TimeZoneUtil.java","0","0","0","0","0"
"1","HttpServer.java","46299","89947","136246","46299","46299.0"
"1","QueryExecutorServlet.java","17235","24409","41644","17235","17235.0"
"1","StaticHttpServer.java","82697","314176","396873","82697","82697.0"
"1","AbstractFetcher.java","0","0","0","0","0"
"1","DeletionService.java","0","0","0","0","0"
"1","ExecutionBlockErrorEvent.java","108386","212992","321378","108386","108386.0"
"1","ExecutionBlockStopEvent.java","7998","13700","21698","7998","7998.0"
"1","NodeResourceAllocateEvent.java","24071","29501","53572","24071","24071.0"
"1","NodeResourceDeallocateEvent.java","24071","29501","53572","24071","24071.0"
"1","NodeResourceEvent.java","18376","18104","36480","18376","18376.0"
"1","NodeStatusEvent.java","0","0","0","0","0"
"1","QMResourceAllocateEvent.java","0","0","0","0","0"
"1","QueryStopEvent.java","108386","212992","321378","108386","108386.0"
"1","TaskManagerEvent.java","0","0","0","0","0"
"1","TaskStartEvent.java","18376","18104","36480","18376","18376.0"
"1","ExecutionBlockContext.java","69324","102891","172215","69324","69324.0"
"1","ExecutionBlockSharedResource.java","855","2076","2931","855","855.0"
"1","FetchImpl.java","10402","37478","47880","10402","10402.0"
"1","LocalFetcher.java","0","0","0","0","0"
"1","NodeResourceManager.java","7998","13700","21698","7998","7998.0"
"1","NodeStatusUpdater.java","7998","13700","21698","7998","7998.0"
"1","RemoteFetcher.java","49312","109844","159156","49312","49312.0"
"1","ConnectivityCheckerRuleForTajoWorker.java","12","123","135","12","12.0"
"1","WorkerRuleProvider.java","0","0","0","0","0"
"1","TajoQueryEngine.java","0","0","0","0","0"
"1","TajoWorker.java","27883","74247","102130","27883","27883.0"
"1","TajoWorkerClientService.java","47156","127251","174407","47156","47156.0"
"1","TajoWorkerManagerService.java","27925","78017","105942","27925","27925.0"
"1","Task.java","46290","88221","134511","46290","46290.0"
"1","TaskAttemptContext.java","49672","111858","161530","49672","49672.0"
"1","TaskContainer.java","0","0","0","0","0"
"1","TaskExecutor.java","18376","18104","36480","18376","18376.0"
"1","TaskHistory.java","41045","60189","101234","41045","41045.0"
"1","TaskImpl.java","18376","18104","36480","18376","18376.0"
"1","TaskManager.java","18376","18104","36480","18376","18376.0"
"1","RestReturnType.java","0","0","0","0","0"
"1","ClientApplication.java","10959","18318","29277","10959","10959.0"
"1","JerseyResourceDelegate.java","0","0","0","0","0"
"1","JerseyResourceDelegateContext.java","0","0","0","0","0"
"1","JerseyResourceDelegateContextKey.java","0","0","0","0","0"
"1","JerseyResourceDelegateUtil.java","0","0","0","0","0"
"1","NewDatabaseRequest.java","0","0","0","0","0"
"1","NewSessionRequest.java","0","0","0","0","0"
"1","SubmitQueryRequest.java","0","0","0","0","0"
"1","ClusterResource.java","35483","86544","122027","35483","35483.0"
"1","DatabasesResource.java","5770","11966","17736","5770","5770.0"
"1","FunctionsResource.java","24865","76158","101023","24865","24865.0"
"1","AbstractStreamingOutput.java","0","0","0","0","0"
"1","BinaryStreamingOutput.java","0","0","0","0","0"
"1","CSVStreamingOutput.java","0","0","0","0","0"
"1","RestOutputFactory.java","0","0","0","0","0"
"1","QueryResource.java","21796","69980","91776","21796","21796.0"
"1","QueryResultResource.java","27107","79829","106936","27107","27107.0"
"1","SessionsResource.java","0","0","0","0","0"
"1","TablesResource.java","27128","79851","106979","27128","27128.0"
"1","ResourcesUtil.java","0","0","0","0","0"
"1","DatabaseInfoResponse.java","0","0","0","0","0"
"1","ExceptionResponse.java","0","0","0","0","0"
"1","GetQueryResultDataResponse.java","0","0","0","0","0"
"1","GetSubmitQueryResponse.java","0","0","0","0","0"
"1","NewSessionResponse.java","0","0","0","0","0"
"1","ResultSetInfoResponse.java","0","0","0","0","0"
"1","WorkerConnectionInfoResponse.java","0","0","0","0","0"
"1","WorkerResponse.java","5770","11966","17736","5770","5770.0"
"1","TajoRestService.java","0","0","0","0","0"
"1","TestTPCH.java","83580","375555","459135","83580","83580.0"
"1","TestDDLBuilder.java","33393","80886","114279","33393","33393.0"
"1","TestTajoDump.java","116090","116563","232653","116090","116090.0"
"1","TestExecExternalShellCommand.java","0","0","0","0","0"
"1","TestHdfsCommand.java","0","0","0","0","0"
"1","TestDefaultCliOutputFormatter.java","11402","43570","54972","11402","11402.0"
"1","TestSimpleParser.java","1940","11496","13436","1940","1940.0"
"1","TestTajoCli.java","263","621","884","263","263.0"
"1","TestTajoCliNegatives.java","109654","140944","250598","109654","109654.0"
"1","TestCatalogAdminClientExceptions.java","0","0","0","0","0"
"1","TestQueryClientExceptions.java","106912","116183","223095","106912","106912.0"
"1","TestTajoClient.java","47331","95236","142567","47331","47331.0"
"1","TestTajoClientV2.java","3446","5585","9031","3446","3446.0"
"1","TestWorkerConnectionInfo.java","0","0","0","0","0"
"1","TestEvalCodeGenerator.java","0","0","0","0","0"
"1","TestGeneratorAdapter.java","0","0","0","0","0"
"1","ExprTestBase.java","27596","74520","102116","27596","27596.0"
"1","TestEvalTree.java","50436","118362","168798","50436","50436.0"
"1","TestEvalTreeUtil.java","47541","105513","153054","47541","47541.0"
"1","TestIntervalType.java","2925","16860","19785","2925","2925.0"
"1","TestPredicates.java","27178","57397","84575","27178","27178.0"
"1","TestSQLDateTimeTypes.java","48415","106907","155322","48415","48415.0"
"1","TestSQLExpression.java","3482","9203","12685","3482","3482.0"
"1","HiveUDFtest.java","0","0","0","0","0"
"1","TestHiveFunctionLoader.java","0","0","0","0","0"
"1","TestHiveFunctions.java","0","0","0","0","0"
"1","NullTestFunction.java","0","0","0","0","0"
"1","TestAggFunction.java","0","0","0","0","0"
"1","TestBuiltinFunctions.java","49915","112229","162144","49915","49915.0"
"1","TestConditionalExpressions.java","119141","139210","258351","119141","119141.0"
"1","TestDateTimeFunctions.java","37345","55741","93086","37345","37345.0"
"1","TestFunctionLoader.java","150215","295778","445993","150215","150215.0"
"1","TestGeneralFunction.java","0","0","0","0","0"
"1","TestJsonFunctions.java","46246","106952","153198","46246","46246.0"
"1","TestMathFunctions.java","391","1936","2327","391","391.0"
"1","TestPatternMatchingPredicates.java","0","0","0","0","0"
"1","TestPythonFunctions.java","1668","4550","6218","1668","1668.0"
"1","TestStringOperatorsAndFunctions.java","23660","55720","79380","23660","23660.0"
"1","TestUserDefinedFunctions.java","0","0","0","0","0"
"1","TestMasterPlan.java","0","0","0","0","0"
"1","TestExternalSortExec.java","59834","133461","193295","59834","59834.0"
"1","TestFullOuterHashJoinExec.java","52811","124698","177509","52811","52811.0"
"1","TestFullOuterMergeJoinExec.java","47745","108430","156175","47745","47745.0"
"1","TestHashAntiJoinExec.java","43456","123033","166489","43456","43456.0"
"1","TestHashJoinExec.java","60665","137646","198311","60665","60665.0"
"1","TestHashPartitioner.java","82254","214654","296908","82254","82254.0"
"1","TestHashSemiJoinExec.java","45226","135684","180910","45226","45226.0"
"1","TestLeftOuterHashJoinExec.java","46797","103790","150587","46797","46797.0"
"1","TestMergeJoinExec.java","61564","150556","212120","61564","61564.0"
"1","TestPhysicalPlanner.java","49672","111858","161530","49672","49672.0"
"1","TestProgressExternalSortExec.java","4805","14121","18926","4805","4805.0"
"1","TestRadixSort.java","0","0","0","0","0"
"1","TestRightOuterHashJoinExec.java","46797","103790","150587","46797","46797.0"
"1","TestRightOuterMergeJoinExec.java","47745","108430","156175","47745","47745.0"
"1","TestSortExec.java","59857","133967","193824","59857","59857.0"
"1","TestSortIntersectExec.java","112995","131080","244075","112995","112995.0"
"1","TestTupleSorter.java","41314","102190","143504","41314","41314.0"
"1","TestUnSafeTuple.java","0","0","0","0","0"
"1","TestEvalNodeToExprConverter.java","0","0","0","0","0"
"1","TestJoinOrderAlgorithm.java","0","0","0","0","0"
"1","TestLogicalOptimizer.java","60749","138539","199288","60749","60749.0"
"1","TestLogicalPlan.java","93091","414659","507750","93091","93091.0"
"1","TestLogicalPlanner.java","50436","118362","168798","50436","50436.0"
"1","TestPlannerUtil.java","60749","138539","199288","60749","60749.0"
"1","TestQueryValidation.java","71557","99893","171450","71557","71557.0"
"1","TestUniformRangePartition.java","60372","134470","194842","60372","60372.0"
"1","TestAlterTable.java","148486","293626","442112","148486","148486.0"
"1","TestAlterTablespace.java","0","0","0","0","0"
"1","TestCaseByCases.java","0","0","0","0","0"
"1","TestCommonConditionReduce.java","0","0","0","0","0"
"1","TestCreateDatabase.java","316","463","779","316","316.0"
"1","TestCreateIndex.java","0","0","0","0","0"
"1","TestCreateTable.java","316","463","779","316","316.0"
"1","TestCrossJoin.java","0","0","0","0","0"
"1","TestCTASQuery.java","8112","11297","19409","8112","8112.0"
"1","TestDropTable.java","0","0","0","0","0"
"1","TestGroupByQuery.java","49915","112229","162144","49915","49915.0"
"1","TestHBaseTable.java","21013","25417","46430","21013","21013.0"
"1","TestIndexScan.java","0","0","0","0","0"
"1","TestInnerJoinQuery.java","0","0","0","0","0"
"1","TestInnerJoinWithSubQuery.java","124473","150320","274793","124473","124473.0"
"1","TestInsertQuery.java","33373","102568","135941","33373","33373.0"
"1","TestInSubquery.java","0","0","0","0","0"
"1","TestJoinOnPartitionedTables.java","14413","29295","43708","14413","14413.0"
"1","TestJoinQuery.java","49915","112229","162144","49915","49915.0"
"1","TestJsonWithTimezone.java","0","0","0","0","0"
"1","TestMultipleJoinTypes.java","29163","38196","67359","29163","29163.0"
"1","TestNullValues.java","61023","144885","205908","61023","61023.0"
"1","TestOuterJoinQuery.java","8068","12633","20701","8068","8068.0"
"1","TestOuterJoinWithSubQuery.java","0","0","0","0","0"
"1","TestQueryOnSelfDescTable.java","1515","5833","7348","1515","1515.0"
"1","TestSelectNestedRecord.java","39148","90524","129672","39148","39148.0"
"1","TestSelectQuery.java","49915","112229","162144","49915","49915.0"
"1","TestSetSessionQuery.java","130433","261567","392000","130433","130433.0"
"1","TestSimpleQuery.java","0","0","0","0","0"
"1","TestSortQuery.java","49915","112229","162144","49915","49915.0"
"1","TestTablePartitions.java","12241","17692","29933","12241","12241.0"
"1","TestTableSubQuery.java","26501","64488","90989","26501","26501.0"
"1","TestTimezone.java","0","0","0","0","0"
"1","TestTruncateTable.java","72329","177897","250226","72329","72329.0"
"1","TestUnionQuery.java","38604","59670","98274","38604","38604.0"
"1","TestWindowQuery.java","3329","13805","17134","3329","3329.0"
"1","BenchmarkSort.java","0","0","0","0","0"
"1","TestTableCache.java","0","0","0","0","0"
"1","TestTupleUtil.java","47541","105513","153054","47541","47541.0"
"1","TestHAServiceHDFSImpl.java","42223","113600","155823","42223","42223.0"
"1","TestMasterRules.java","0","0","0","0","0"
"1","TestSimpleScheduler.java","0","0","0","0","0"
"1","TestExecutionBlockCursor.java","15256","26834","42090","41469","41469.0"
"1","TestNonForwardQueryResultSystemScanner.java","22815","25117","47932","22815","22815.0"
"1","TestQueryResult.java","0","0","0","0","0"
"1","TestRepartitioner.java","82324","215608","297932","82324","82324.0"
"1","TestSQLAnalyzer.java","50545","131417","181962","50545","50545.0"
"1","TestIntermediateEntry.java","0","0","0","0","0"
"1","TestKillQuery.java","72356","106622","178978","72356","72356.0"
"1","TestQueryProgress.java","84042","122362","206404","84042","84042.0"
"1","TestQueryState.java","31801","77988","109789","31801","31801.0"
"1","TestTaskStatusUpdate.java","4805","14121","18926","4805","4805.0"
"1","TestResources.java","0","0","0","0","0"
"1","TestFileFragment.java","0","0","0","0","0"
"1","TestQueryOnOrcFile.java","0","0","0","0","0"
"1","TestQueryIdFactory.java","82703","306590","389293","82703","82703.0"
"1","TestTajoIds.java","82703","306590","389293","82703","82703.0"
"1","TestHistoryWriterReader.java","36471","53136","89607","36471","36471.0"
"1","TestJMXTajoObjectNameFactory.java","0","0","0","0","0"
"1","TestMetricsFilter.java","0","0","0","0","0"
"1","TestSystemMetrics.java","129236","370559","499795","129236","129236.0"
"1","TestIPconvertUtil.java","0","0","0","0","0"
"1","TestJSPUtil.java","123948","251494","375442","123948","123948.0"
"1","TestRpcParamFactory.java","0","0","0","0","0"
"1","TestTimeZoneUtil.java","0","0","0","0","0"
"1","MockExecutionBlockContext.java","0","0","0","0","0"
"1","MockNodeResourceManager.java","18376","18104","36480","18376","18376.0"
"1","MockNodeStatusUpdater.java","24071","29501","53572","24071","24071.0"
"1","MockTaskExecutor.java","18376","18104","36480","18376","18376.0"
"1","MockTaskManager.java","18376","18104","36480","18376","18376.0"
"1","MockWorkerContext.java","0","0","0","0","0"
"1","TestDeletionService.java","0","0","0","0","0"
"1","TestFetcherWithTajoPullServer.java","0","0","0","0","0"
"1","TestNodeResourceManager.java","7998","13700","21698","7998","7998.0"
"1","TestNodeStatusUpdater.java","7998","13700","21698","7998","7998.0"
"1","TestTaskExecutor.java","18376","18104","36480","18376","18376.0"
"1","TestTaskManager.java","18376","18104","36480","18376","18376.0"
"1","TestClusterResource.java","0","0","0","0","0"
"1","TestDatabasesResource.java","0","0","0","0","0"
"1","TestFunctionsResource.java","24865","76158","101023","24865","24865.0"
"1","TestQueryResource.java","21796","69980","91776","21796","21796.0"
"1","TestQueryResultResource.java","21796","69980","91776","21796","21796.0"
"1","TestSessionsResource.java","0","0","0","0","0"
"1","TestTablesResource.java","27128","79851","106979","27128","27128.0"
"1","JdbcConnection.java","49314","96513","145827","49314","49314.0"
"1","TajoDatabaseMetaData.java","49314","96513","145827","49314","49314.0"
"1","TajoDriver.java","0","0","0","0","0"
"1","TajoPreparedStatement.java","114590","262376","376966","114590","114590.0"
"1","TajoStatement.java","47714","85635","133349","47714","47714.0"
"1","QueryStringDecoder.java","0","0","0","0","0"
"1","TestResultSet.java","60749","138539","199288","60749","60749.0"
"1","TestSQLState.java","0","0","0","0","0"
"1","TestTajoDatabaseMetaData.java","116150","120555","236705","116150","116150.0"
"1","TestTajoJdbc.java","49314","96513","145827","49314","49314.0"
"1","TestTajoJdbcNegative.java","6339","9293","15632","6339","6339.0"
"1","TestQueryStringDecoder.java","0","0","0","0","0"
"1","TestResultSetUtil.java","0","0","0","0","0"
"1","ProtocMojo.java","0","0","0","0","0"
"1","Exec.java","0","0","0","0","0"
"1","FileSetUtils.java","0","0","0","0","0"
"1","VersionInfoMojo.java","0","0","0","0","0"
"1","MetricsUtil.java","0","0","0","0","0"
"1","TestMetricsUtil.java","0","0","0","0","0"
"1","AlgebraVisitor.java","36291","98512","134803","36291","36291.0"
"1","BaseAlgebraVisitor.java","36291","98512","134803","36291","36291.0"
"1","Prioritized.java","0","0","0","0","0"
"1","AggregationFunctionCallEval.java","82121","207772","289893","82121","82121.0"
"1","AlgebraicException.java","0","0","0","0","0"
"1","AlgebraicUtil.java","47541","105513","153054","47541","47541.0"
"1","BasicEvalNodeVisitor.java","25774","66332","92106","25774","25774.0"
"1","BetweenPredicateEval.java","23895","57248","81143","23895","23895.0"
"1","BinaryEval.java","48415","106732","155147","48415","48415.0"
"1","CaseWhenEval.java","51141","121619","172760","51141","51141.0"
"1","CastEval.java","25258","70990","96248","25258","25258.0"
"1","ConstEval.java","51141","121619","172760","51141","51141.0"
"1","EvalContext.java","1668","4550","6218","1668","1668.0"
"1","EvalNode.java","81946","188259","270205","81946","81946.0"
"1","EvalNodeVisitor.java","0","0","0","0","0"
"1","EvalNodeVisitor2.java","51593","117699","169292","51593","51593.0"
"1","EvalTreeFactory.java","0","0","0","0","0"
"1","EvalTreeUtil.java","47541","105513","153054","47541","47541.0"
"1","EvalType.java","75277","186488","261765","75277","75277.0"
"1","FieldEval.java","82349","221551","303900","82349","82349.0"
"1","FunctionEval.java","82338","218465","300803","82338","82338.0"
"1","GeneralFunctionEval.java","51141","121619","172760","51141","51141.0"
"1","InEval.java","32745","101437","134182","32745","32745.0"
"1","InvalidEvalException.java","0","0","0","0","0"
"1","IsNullEval.java","81946","188259","270205","81946","81946.0"
"1","LikePredicateEval.java","26241","72267","98508","26241","26241.0"
"1","NotEval.java","83604","321848","405452","83604","83604.0"
"1","PartialBinaryExpr.java","81946","188259","270205","81946","81946.0"
"1","PatternMatchPredicateEval.java","34381","92913","127294","34381","34381.0"
"1","RegexPredicateEval.java","92794","317139","409933","92794","92794.0"
"1","RowConstantEval.java","33517","104761","138278","33517","33517.0"
"1","SignedEval.java","119415","175737","295152","119415","119415.0"
"1","SimilarToPredicateEval.java","91366","268519","359885","91366","91366.0"
"1","SimpleEvalNodeVisitor.java","8079","27417","35496","8079","8079.0"
"1","SubqueryEval.java","0","0","0","0","0"
"1","UnaryEval.java","11011","43900","54911","11011","11011.0"
"1","ValueSetEval.java","0","0","0","0","0"
"1","WindowFunctionEval.java","35808","106404","142212","35808","35808.0"
"1","ExprAnnotator.java","1043","2261","3304","1043","1043.0"
"1","ExprNormalizer.java","34246","43677","77923","34246","34246.0"
"1","EvalTreeOptimizationRule.java","34320","94440","128760","34320","34320.0"
"1","EvalTreeOptimizer.java","3179","63032","66211","3179","3179.0"
"1","ConstantFolding.java","86258","188375","274633","86258","86258.0"
"1","ConstantPropagation.java","34320","94440","128760","34320","34320.0"
"1","AggFunction.java","83622","334927","418549","83622","83622.0"
"1","AggFunctionInvoke.java","0","0","0","0","0"
"1","ClassBasedAggFunctionInvoke.java","0","0","0","0","0"
"1","ClassBasedScalarFunctionInvoke.java","1668","4550","6218","1668","1668.0"
"1","FunctionContext.java","0","0","0","0","0"
"1","FunctionInvoke.java","83256","142984","226240","83256","83256.0"
"1","FunctionInvokeContext.java","1668","4550","6218","1668","1668.0"
"1","GeneralFunction.java","82592","295074","377666","82592","82592.0"
"1","HiveFunctionInvoke.java","0","0","0","0","0"
"1","PythonScriptEngine.java","1668","4550","6218","1668","1668.0"
"1","TajoScriptEngine.java","1668","4550","6218","1668","1668.0"
"1","PythonAggFunctionInvoke.java","0","0","0","0","0"
"1","PythonFunctionInvoke.java","0","0","0","0","0"
"1","BufferPool.java","66502","110968","177470","66502","66502.0"
"1","ByteBufInputChannel.java","0","0","0","0","0"
"1","ByteBufLineReader.java","4085","11290","15375","4085","4085.0"
"1","CSVLineDeserializer.java","57980","81059","139039","57980","57980.0"
"1","CSVLineSerDe.java","66186","103979","170165","66186","66186.0"
"1","CSVLineSerializer.java","57980","81059","139039","57980","57980.0"
"1","FieldSerializerDeserializer.java","66502","110968","177470","66502","66502.0"
"1","FieldSplitProcessor.java","0","0","0","0","0"
"1","InputHandler.java","0","0","0","0","0"
"1","LineSplitProcessor.java","0","0","0","0","0"
"1","OutputHandler.java","1668","4550","6218","1668","1668.0"
"1","StreamingUtil.java","1668","4550","6218","1668","1668.0"
"1","TextFieldSerializerDeserializer.java","1479","7317","8796","1479","1479.0"
"1","TextLineDeserializer.java","66186","103979","170165","66186","66186.0"
"1","TextLineParsingError.java","0","0","0","0","0"
"1","TextLineSerDe.java","66186","103979","170165","66186","66186.0"
"1","TextLineSerializer.java","1668","4550","6218","1668","1668.0"
"1","WindowAggFunc.java","0","0","0","0","0"
"1","Edge.java","0","0","0","0","0"
"1","FoundJoinOrder.java","0","0","0","0","0"
"1","GreedyHeuristicJoinOrderAlgorithm.java","17848","29313","47161","17848","17848.0"
"1","JoinEdge.java","100877","377154","478031","100877","100877.0"
"1","JoinedRelationsVertex.java","0","0","0","0","0"
"1","JoinGraph.java","98907","199629","298536","98907","98907.0"
"1","JoinGraphContext.java","18640","16847","35487","18640","18640.0"
"1","JoinOrderAlgorithm.java","17848","29313","47161","17848","17848.0"
"1","JoinOrderingUtil.java","22597","29806","52403","22597","22597.0"
"1","JoinVertex.java","0","0","0","0","0"
"1","RelationVertex.java","0","0","0","0","0"
"1","AlterTableNode.java","144736","277945","422681","144736","144736.0"
"1","AlterTablespaceNode.java","149801","276116","425917","149801","149801.0"
"1","BinaryNode.java","0","0","0","0","0"
"1","CreateDatabaseNode.java","141361","279432","420793","141361","141361.0"
"1","CreateIndexNode.java","0","0","0","0","0"
"1","CreateTableNode.java","50605","120404","171009","50605","50605.0"
"1","DistinctGroupbyNode.java","12726","97085","109811","12726","12726.0"
"1","DropDatabaseNode.java","141361","279432","420793","141361","141361.0"
"1","DropIndexNode.java","0","0","0","0","0"
"1","DropTableNode.java","36153","91701","127854","36153","36153.0"
"1","EvalExprNode.java","50436","118362","168798","50436","50436.0"
"1","ExceptNode.java","60863","138506","199369","60863","60863.0"
"1","GroupbyNode.java","50436","118362","168798","50436","50436.0"
"1","GroupElement.java","40534","114409","154943","40534","40534.0"
"1","HavingNode.java","127846","249019","376865","127846","127846.0"
"1","IndexScanNode.java","83594","319885","403479","83594","83594.0"
"1","InsertNode.java","33046","100368","133414","33046","33046.0"
"1","IntersectNode.java","60863","138506","199369","60863","60863.0"
"1","JoinNode.java","50436","118362","168798","50436","50436.0"
"1","JoinSpec.java","0","0","0","0","0"
"1","LimitNode.java","50436","118362","168798","50436","50436.0"
"1","LogicalNode.java","47353","96962","144315","47353","47353.0"
"1","LogicalNodeVisitor.java","0","0","0","0","0"
"1","LogicalRootNode.java","0","0","0","0","0"
"1","NodeType.java","33168","97782","130950","33168","33168.0"
"1","PartitionedTableScanNode.java","42375","62046","104421","42375","42375.0"
"1","PersistentStoreNode.java","7357","14970","22327","7357","7357.0"
"1","Projectable.java","50436","118362","168798","50436","50436.0"
"1","ProjectionNode.java","61925","159928","221853","61925","61925.0"
"1","RelationNode.java","33977","90798","124775","33977","33977.0"
"1","ScanNode.java","47541","105513","153054","47541","47541.0"
"1","SelectableNode.java","0","0","0","0","0"
"1","SelectionNode.java","82390","271489","353879","82390","82390.0"
"1","SetOperationNode.java","0","0","0","0","0"
"1","SetSessionNode.java","0","0","0","0","0"
"1","ShuffleFileWriteNode.java","7357","14970","22327","7357","7357.0"
"1","SortNode.java","50436","118362","168798","50436","50436.0"
"1","StoreTableNode.java","50605","120404","171009","50605","50605.0"
"1","TableSubQueryNode.java","33977","90798","124775","33977","33977.0"
"1","TruncateTableNode.java","72329","177897","250226","72329","72329.0"
"1","UnaryNode.java","0","0","0","0","0"
"1","UnionNode.java","50436","118362","168798","50436","50436.0"
"1","WindowAggNode.java","134154","347585","481739","134154","134154.0"
"1","WindowSpec.java","69654","171066","240720","69654","69654.0"
"1","LogicalOptimizer.java","47339","96431","143770","47339","47339.0"
"1","LogicalPlan.java","40534","114409","154943","40534","40534.0"
"1","LogicalPlanner.java","47331","95236","142567","47331","47331.0"
"1","LogicalPlanPreprocessor.java","135500","380493","515993","135500","135500.0"
"1","NamedExprsManager.java","24937","27767","52704","24937","24937.0"
"1","NameResolver.java","89225","209410","298635","89225","89225.0"
"1","NameResolvingMode.java","0","0","0","0","0"
"1","ResolverByLegacy.java","35159","99838","134997","35159","35159.0"
"1","ResolverByRels.java","35159","99838","134997","35159","35159.0"
"1","ResolverByRelsAndSubExprs.java","35159","99838","134997","35159","35159.0"
"1","ResolverBySubExprsAndRels.java","35159","99838","134997","35159","35159.0"
"1","PlanString.java","48387","113677","162064","48387","48387.0"
"1","BaseLogicalPlanPreprocessEngine.java","0","0","0","0","0"
"1","BaseLogicalPlanPreprocessPhaseProvider.java","0","0","0","0","0"
"1","BaseLogicalPlanRewriteEngine.java","75417","189024","264441","75417","75417.0"
"1","BaseLogicalPlanRewriteRuleProvider.java","67172","146683","213855","67172","67172.0"
"1","BaseSchemaBuildPhase.java","2958","22080","25038","2958","2958.0"
"1","LogicalPlanPreprocessEngine.java","0","0","0","0","0"
"1","LogicalPlanPreprocessPhase.java","0","0","0","0","0"
"1","LogicalPlanPreprocessPhaseProvider.java","0","0","0","0","0"
"1","LogicalPlanRewriteEngine.java","75999","308832","384831","75999","75999.0"
"1","LogicalPlanRewriteRule.java","75872","277889","353761","75872","75872.0"
"1","LogicalPlanRewriteRuleContext.java","115965","156612","272577","115965","115965.0"
"1","LogicalPlanRewriteRuleProvider.java","0","0","0","0","0"
"1","LogicalPlanTestRuleProvider.java","0","0","0","0","0"
"1","AccessPathInfo.java","0","0","0","0","0"
"1","AccessPathRewriter.java","0","0","0","0","0"
"1","CommonConditionReduceRule.java","95581","98270","193851","95581","95581.0"
"1","FilterPushDownRule.java","33571","97991","131562","33571","33571.0"
"1","IndexScanInfo.java","0","0","0","0","0"
"1","InSubqueryRewriteRule.java","0","0","0","0","0"
"1","LogicalPlanEqualityTester.java","65395","138862","204257","65395","65395.0"
"1","PartitionedTableRewriter.java","19549","31820","51369","19549","19549.0"
"1","ProjectionPushDownRule.java","38135","112509","150644","38135","38135.0"
"1","SeqScanInfo.java","0","0","0","0","0"
"1","SelfDescSchemaBuildPhase.java","1515","5833","7348","1515","1515.0"
"1","TableStatUpdateRewriter.java","5027","8110","13137","5027","5027.0"
"1","EvalNodeAdapter.java","82572","278819","361391","82572","82572.0"
"1","EvalNodeDeserializer.java","73002","160863","233865","73002","73002.0"
"1","EvalNodeSerializer.java","73002","160863","233865","73002","73002.0"
"1","LogicalNodeAdapter.java","82572","278819","361391","82572","82572.0"
"1","LogicalNodeDeserializer.java","23033","29473","52506","23033","23033.0"
"1","LogicalNodeSerializer.java","23033","29473","52506","23033","23033.0"
"1","package-info.java","0","0","0","0","0"
"1","PlanGsonHelper.java","0","0","0","0","0"
"1","StorageService.java","123914","158234","282148","123914","123914.0"
"1","TablePropertyUtil.java","127059","169535","296594","127059","127059.0"
"1","Target.java","36416","100337","136753","36416","36416.0"
"1","TypeDeterminant.java","6109","76438","82547","6109","6109.0"
"1","EvalNodeToExprConverter.java","5892","9575","15467","5892","5892.0"
"1","ExprFinder.java","134808","364207","499015","134808","134808.0"
"1","PartitionFilterAlgebraVisitor.java","0","0","0","0","0"
"1","PlannerUtil.java","47339","96431","143770","47339","47339.0"
"1","WritableTypeConverter.java","0","0","0","0","0"
"1","ExprsVerifier.java","23807","57634","81441","23807","23807.0"
"1","LogicalPlanVerifier.java","17109","40174","57283","17109","17109.0"
"1","PostLogicalPlanVerifier.java","0","0","0","0","0"
"1","PreLogicalPlanVerifier.java","1265","1944","3209","1265","1265.0"
"1","SyntaxErrorException.java","114440","374153","488593","114440","114440.0"
"1","SyntaxErrorUtil.java","113147","127045","240192","113147","113147.0"
"1","VerificationState.java","114348","374419","488767","114348","114348.0"
"1","BasicLogicalPlanVisitor.java","35788","101952","137740","35788","35788.0"
"1","ExplainLogicalPlanVisitor.java","30031","78642","108673","30031","30031.0"
"1","LogicalPlanVisitor.java","35788","101952","137740","35788","35788.0"
"1","SimpleAlgebraVisitor.java","39281","65209","104490","39281","39281.0"
"1","TestExprAnnotator.java","0","0","0","0","0"
"1","TestLogicalNode.java","50436","118362","168798","50436","50436.0"
"1","TestWritableTypeConverter.java","0","0","0","0","0"
"1","FadvisedChunkedFile.java","84814","126137","210951","84814","84814.0"
"1","FadvisedFileRegion.java","84814","126137","210951","84814","84814.0"
"1","FileAccessForbiddenException.java","0","0","0","0","0"
"1","FileCloseListener.java","144714","284640","429354","144714","144714.0"
"1","HttpDataServerChannelInitializer.java","82775","314577","397352","82775","82775.0"
"1","HttpDataServerHandler.java","82775","314577","397352","82775","82775.0"
"1","HttpUtil.java","0","0","0","0","0"
"1","PullServerConstants.java","0","0","0","0","0"
"1","PullServerUtil.java","0","0","0","0","0"
"1","AdvancedDataRetriever.java","82703","306590","389293","82703","82703.0"
"1","DataRetriever.java","0","0","0","0","0"
"1","DirectoryRetriever.java","0","0","0","0","0"
"1","FileChunk.java","0","0","0","0","0"
"1","FileChunkMeta.java","0","0","0","0","0"
"1","IndexCacheKey.java","0","0","0","0","0"
"1","RetrieverHandler.java","0","0","0","0","0"
"1","TajoPullServer.java","0","0","0","0","0"
"1","TajoPullServerService.java","32712","96804","129516","32712","32712.0"
"1","NettyServerBase.java","60532","135764","196296","60532","60532.0"
"1","NettyUtils.java","6187","30766","36953","6187","6187.0"
"1","RemoteException.java","0","0","0","0","0"
"1","RetriesExhaustedException.java","0","0","0","0","0"
"1","RpcConstants.java","0","0","0","0","0"
"1","RpcEventListener.java","0","0","0","0","0"
"1","RpcUtils.java","11197","14951","26148","11197","11197.0"
"1","AsyncRpcClient.java","82775","314577","397352","82775","82775.0"
"1","AsyncRpcServer.java","60532","135764","196296","60532","60532.0"
"1","BlockingRpcClient.java","50521","119787","170308","50521","50521.0"
"1","BlockingRpcServer.java","60532","135764","196296","60532","60532.0"
"1","CallFuture.java","82775","314577","397352","82775","82775.0"
"1","CancelableRpcCallback.java","0","0","0","0","0"
"1","ChannelEventListener.java","4696","9687","14383","4696","4696.0"
"1","DefaultRpcController.java","111725","305662","417387","111725","111725.0"
"1","MonitorClientHandler.java","0","0","0","0","0"
"1","MonitorServerHandler.java","0","0","0","0","0"
"1","MonitorStateEvent.java","0","0","0","0","0"
"1","NettyClientBase.java","82389","273152","355541","82389","82389.0"
"1","NettyRpcController.java","0","0","0","0","0"
"1","NullCallback.java","83604","328510","412114","83604","83604.0"
"1","ProtoClientChannelInitializer.java","12183","30442","42625","12183","12183.0"
"1","ProtoDeclaration.java","0","0","0","0","0"
"1","ProtoServerChannelInitializer.java","0","0","0","0","0"
"1","RecoverableException.java","4696","9687","14383","4696","4696.0"
"1","RemoteCallException.java","81830","184912","266742","81830","81830.0"
"1","RpcClientManager.java","4696","9687","14383","4696","4696.0"
"1","RpcConnectionKey.java","0","0","0","0","0"
"1","TajoServiceException.java","0","0","0","0","0"
"1","DummyProtocolAsyncImpl.java","83622","333683","417305","83622","83622.0"
"1","DummyProtocolBlockingImpl.java","83622","333683","417305","83622","83622.0"
"1","TestAsyncRpc.java","61851","154103","215954","61851","61851.0"
"1","TestBlockingRpc.java","61851","154103","215954","61851","61851.0"
"1","TestRpcClientManager.java","4696","9687","14383","4696","4696.0"
"1","GsonFeature.java","3540","11523","15063","3540","3540.0"
"1","GsonReader.java","0","0","0","0","0"
"1","GsonUtil.java","0","0","0","0","0"
"1","GsonWriter.java","0","0","0","0","0"
"1","NettyRestChannelInitializer.java","0","0","0","0","0"
"1","NettyRestHandlerContainer.java","0","0","0","0","0"
"1","NettyRestHandlerContainerProvider.java","0","0","0","0","0"
"1","NettyRestServer.java","0","0","0","0","0"
"1","NettyRestServerFactory.java","0","0","0","0","0"
"1","NettyRestServerListener.java","0","0","0","0","0"
"1","ResourceConfigUtil.java","0","0","0","0","0"
"1","NettyRestHandlerContainerProviderTest.java","0","0","0","0","0"
"1","NettyRestServerTest.java","0","0","0","0","0"
"1","TestApplication1.java","0","0","0","0","0"
"1","TestResource1.java","0","0","0","0","0"
"1","DirectoriesDao.java","0","0","0","0","0"
"1","DirectoriesResource.java","0","0","0","0","0"
"1","Directory.java","0","0","0","0","0"
"1","FileManagementApplication.java","0","0","0","0","0"
"1","AbstractScanner.java","84967","154628","239595","84967","84967.0"
"1","ForSplitableStore.java","0","0","0","0","0"
"1","Appender.java","82338","217588","299926","82338","82338.0"
"1","BaseTupleComparator.java","126971","262752","389723","126971","126971.0"
"1","BinarySerializerDeserializer.java","3267","13248","16515","3267","3267.0"
"1","ByteBufInputChannel.java","0","0","0","0","0"
"1","CodecPool.java","0","0","0","0","0"
"1","DataLocation.java","0","0","0","0","0"
"1","DiskDeviceInfo.java","0","0","0","0","0"
"1","DiskInfo.java","0","0","0","0","0"
"1","DiskMountInfo.java","35675","97302","132977","35675","35675.0"
"1","DiskUtil.java","35675","97302","132977","35675","35675.0"
"1","AlreadyExistsStorageException.java","0","0","0","0","0"
"1","UnknownCodecException.java","0","0","0","0","0"
"1","UnsupportedFileTypeException.java","0","0","0","0","0"
"1","FormatProperty.java","0","0","0","0","0"
"1","BuiltinFragmentKinds.java","0","0","0","0","0"
"1","Fragment.java","0","0","0","0","0"
"1","FragmentConvertor.java","47181","107036","154217","47181","47181.0"
"1","FragmentSerde.java","0","0","0","0","0"
"1","FrameTuple.java","59834","133461","193295","59834","59834.0"
"1","FSDataInputChannel.java","85801","148391","234192","85801","85801.0"
"1","InputChannel.java","0","0","0","0","0"
"1","LazyTuple.java","28160","75736","103896","28160","28160.0"
"1","LocalFileInputChannel.java","41398","95910","137308","41398","41398.0"
"1","MergeScanner.java","47322","91544","138866","47322","47322.0"
"1","NullScanner.java","106029","190576","296605","106029","106029.0"
"1","NumericPathComparator.java","0","0","0","0","0"
"1","OldStorageManager.java","0","0","0","0","0"
"1","RowStoreUtil.java","47415","100369","147784","47415","47415.0"
"1","Scanner.java","82600","306204","388804","82600","82600.0"
"1","SeekableChannel.java","0","0","0","0","0"
"1","SeekableInputChannel.java","0","0","0","0","0"
"1","SeekableScanner.java","0","0","0","0","0"
"1","SerializerDeserializer.java","117849","368326","486175","117849","117849.0"
"1","StorageProperty.java","82600","306204","388804","82600","82600.0"
"1","StorageUtil.java","82121","212666","294787","82121","82121.0"
"1","Tablespace.java","51242","115196","166438","51242","51242.0"
"1","TablespaceManager.java","16903","61846","78749","16903","16903.0"
"1","TableStatistics.java","60749","138539","199288","60749","60749.0"
"1","TextSerializerDeserializer.java","21979","50184","72163","21979","21979.0"
"1","TupleComparator.java","0","0","0","0","0"
"1","TupleRange.java","82350","224216","306566","82350","82350.0"
"1","TestFrameTuple.java","0","0","0","0","0"
"1","TestLazyTuple.java","27757","67950","95707","27757","27757.0"
"1","TestTupleComparator.java","82577","284823","367400","82577","82577.0"
"1","TestVTuple.java","51302","121398","172700","51302","51302.0"
"1","AbstractHBaseAppender.java","71495","152828","224323","71495","71495.0"
"1","ColumnMapping.java","28414","38089","66503","28414","28414.0"
"1","HBaseBinarySerializerDeserializer.java","39567","67716","107283","39567","39567.0"
"1","HBaseFragment.java","0","0","0","0","0"
"1","HBaseFragmentSerde.java","0","0","0","0","0"
"1","HBasePutAppender.java","56224","128780","185004","56224","56224.0"
"1","HBaseScanner.java","28414","38089","66503","28414","28414.0"
"1","HBaseStorageConstants.java","0","0","0","0","0"
"1","HBaseTablespace.java","28414","38089","66503","28414","28414.0"
"1","HBaseTextSerializerDeserializer.java","0","0","0","0","0"
"1","HFileAppender.java","0","0","0","0","0"
"1","IndexPredication.java","0","0","0","0","0"
"1","RegionSizeCalculator.java","0","0","0","0","0"
"1","RowKeyMapping.java","82600","306204","388804","82600","82600.0"
"1","SortedInsertRewriter.java","56224","128780","185004","56224","56224.0"
"1","TestColumnMapping.java","116215","231739","347954","116215","116215.0"
"1","TestHBaseTableSpace.java","56224","128780","185004","56224","56224.0"
"1","AvroAppender.java","150175","271881","422056","150175","150175.0"
"1","AvroScanner.java","157001","351755","508756","157001","157001.0"
"1","AvroUtil.java","132915","241018","373933","132915","132915.0"
"1","package-info.java","0","0","0","0","0"
"1","FieldSerializerDeserializer.java","66502","110968","177470","66502","66502.0"
"1","FileAppender.java","82350","223260","305610","82350","82350.0"
"1","FileScanner.java","60888","140564","201452","60888","60888.0"
"1","FileTablespace.java","18317","90287","108604","18317","18317.0"
"1","AbstractFileFragment.java","0","0","0","0","0"
"1","FileFragment.java","61921","161024","222945","61921","61921.0"
"1","FileFragmentSerde.java","0","0","0","0","0"
"1","HashShuffleAppenderManager.java","144643","343056","487699","144643","144643.0"
"1","HashShuffleAppenderWrapper.java","143976","336073","480049","143976","143976.0"
"1","BSTIndex.java","51302","121398","172700","51302","51302.0"
"1","IndexMethod.java","0","0","0","0","0"
"1","IndexReader.java","0","0","0","0","0"
"1","IndexWriter.java","0","0","0","0","0"
"1","OrderIndexReader.java","0","0","0","0","0"
"1","JsonLineDeserializer.java","30785","43428","74213","30785","30785.0"
"1","JsonLineSerDe.java","67681","108322","176003","67681","67681.0"
"1","JsonLineSerializer.java","90613","182630","273243","90613","90613.0"
"1","ORCAppender.java","5455","17689","23144","5455","5455.0"
"1","OrcScanner.java","0","0","0","0","0"
"1","package-info.java","0","0","0","0","0"
"1","package-info.java","0","0","0","0","0"
"1","ParquetAppender.java","823","3969","4792","823","823.0"
"1","ParquetScanner.java","149994","354731","504725","149994","149994.0"
"1","TajoParquetReader.java","0","0","0","0","0"
"1","TajoParquetWriter.java","0","0","0","0","0"
"1","TajoReadSupport.java","143723","275412","419135","143723","143723.0"
"1","TajoRecordConverter.java","129306","249879","379185","129306","129306.0"
"1","TajoRecordMaterializer.java","153299","402479","555778","153299","153299.0"
"1","TajoSchemaConverter.java","0","0","0","0","0"
"1","TajoWriteSupport.java","149474","309432","458906","149474","149474.0"
"1","DirectRawFileScanner.java","105778","116572","222350","105778","105778.0"
"1","DirectRawFileWriter.java","4513","9802","14315","4513","4513.0"
"1","RawFile.java","48097","105774","153871","48097","48097.0"
"1","BytesRefArrayWritable.java","51302","121398","172700","51302","51302.0"
"1","BytesRefWritable.java","0","0","0","0","0"
"1","ColumnProjectionUtils.java","0","0","0","0","0"
"1","LazyDecompressionCallback.java","0","0","0","0","0"
"1","NonSyncByteArrayInputStream.java","0","0","0","0","0"
"1","NonSyncByteArrayOutputStream.java","46290","88181","134471","46290","46290.0"
"1","NonSyncDataInputBuffer.java","46290","88181","134471","46290","46290.0"
"1","NonSyncDataOutputBuffer.java","0","0","0","0","0"
"1","RCFile.java","46290","88181","134471","46290","46290.0"
"1","SchemaAwareCompressionInputStream.java","0","0","0","0","0"
"1","SchemaAwareCompressionOutputStream.java","0","0","0","0","0"
"1","RegexLineDeserializer.java","0","0","0","0","0"
"1","RegexLineSerDe.java","0","0","0","0","0"
"1","RegexLineSerializer.java","0","0","0","0","0"
"1","SequenceFileAppender.java","117575","153642","271217","117575","117575.0"
"1","SequenceFileScanner.java","117689","156937","274626","117689","117689.0"
"1","ByteBufLineReader.java","4085","11290","15375","4085","4085.0"
"1","CSVLineDeserializer.java","57980","81059","139039","57980","57980.0"
"1","CSVLineSerDe.java","66186","103979","170165","66186","66186.0"
"1","CSVLineSerializer.java","57980","81059","139039","57980","57980.0"
"1","DelimitedLineReader.java","7451","16021","23472","7451","7451.0"
"1","DelimitedTextFile.java","3738","10411","14149","3738","3738.0"
"1","FieldSplitProcessor.java","0","0","0","0","0"
"1","LineSplitProcessor.java","0","0","0","0","0"
"1","MultiBytesFieldSplitProcessor.java","0","0","0","0","0"
"1","TextFieldSerializerDeserializer.java","1479","7317","8796","1479","1479.0"
"1","TextLineDeserializer.java","66186","103979","170165","66186","66186.0"
"1","TextLineParsingError.java","0","0","0","0","0"
"1","TextLineSerDe.java","66186","103979","170165","66186","66186.0"
"1","TextLineSerializer.java","1668","4550","6218","1668","1668.0"
"1","ByteBufferAllocatorPool.java","0","0","0","0","0"
"1","ByteBufferPoolAdapter.java","0","0","0","0","0"
"1","OrcConf.java","0","0","0","0","0"
"1","OrcFile.java","0","0","0","0","0"
"1","OrcRecordReader.java","0","0","0","0","0"
"1","OrcUtils.java","0","0","0","0","0"
"1","package-info.java","0","0","0","0","0"
"1","RecordReaderUtils.java","0","0","0","0","0"
"1","TreeReaderFactory.java","0","0","0","0","0"
"1","BloomFilter.java","0","0","0","0","0"
"1","Murmur3.java","0","0","0","0","0"
"1","Writer.java","0","0","0","0","0"
"1","WriterImpl.java","0","0","0","0","0"
"1","ZeroCopyAdapter.java","0","0","0","0","0"
"1","InternalParquetRecordReader.java","0","0","0","0","0"
"1","ParquetReader.java","0","0","0","0","0"
"1","HttpFileServer.java","57242","79043","136285","57242","57242.0"
"1","HttpFileServerChannelInitializer.java","0","0","0","0","0"
"1","HttpFileServerHandler.java","57242","79043","136285","57242","57242.0"
"1","TestAvroUtil.java","129588","258715","388303","129588","129588.0"
"1","TestBSTIndex.java","48097","105774","153871","48097","48097.0"
"1","TestSingleCSVFileBSTIndex.java","60749","138539","199288","60749","60749.0"
"1","TestJsonSerDe.java","122663","219137","341800","122663","122663.0"
"1","TestReadWrite.java","117131","214315","331446","117131","117131.0"
"1","TestSchemaConverter.java","0","0","0","0","0"
"1","TestDirectRawFile.java","105778","116572","222350","105778","105778.0"
"1","TestRegexSerDe.java","0","0","0","0","0"
"1","TestByteBufLineReader.java","0","0","0","0","0"
"1","TestCompressionStorages.java","24622","67613","92235","24622","24622.0"
"1","TestDelimitedTextFile.java","31079","43203","74282","31079","31079.0"
"1","TestFileSystems.java","30172","43507","73679","30172","30172.0"
"1","TestFileTablespace.java","61921","161024","222945","61921","61921.0"
"1","TestLineReader.java","4085","11290","15375","4085","4085.0"
"1","TestMergeScanner.java","47322","91544","138866","47322","47322.0"
"1","TestSplitProcessor.java","58383","88135","146518","58383","58383.0"
"1","TestStorages.java","46290","88181","134471","46290","46290.0"
"1","TestStorageUtil.java","0","0","0","0","0"
"1","ConnectionInfo.java","0","0","0","0","0"
"1","JdbcFragment.java","0","0","0","0","0"
"1","JdbcFragmentSerde.java","0","0","0","0","0"
"1","JdbcMetadataProviderBase.java","0","0","0","0","0"
"1","JdbcScanner.java","0","0","0","0","0"
"1","JdbcTablespace.java","0","0","0","0","0"
"1","SQLBuilder.java","0","0","0","0","0"
"1","SQLExpressionGenerator.java","0","0","0","0","0"
"1","TestConnectionInfo.java","0","0","0","0","0"
"1","KafkaFragment.java","0","0","0","0","0"
"1","KafkaFragmentSerde.java","0","0","0","0","0"
"1","KafkaScanner.java","0","0","0","0","0"
"1","KafkaStorageConstants.java","0","0","0","0","0"
"1","KafkaTablespace.java","0","0","0","0","0"
"1","SimpleConsumerManager.java","0","0","0","0","0"
"1","KafkaTestUtil.java","0","0","0","0","0"
"1","EmbeddedKafka.java","0","0","0","0","0"
"1","EmbeddedZookeeper.java","0","0","0","0","0"
"1","TestKafkaQuery.java","0","0","0","0","0"
"1","TestKafkaScanner.java","0","0","0","0","0"
"1","TestKafkaTablespace.java","0","0","0","0","0"
"1","TestSimpleConsumerManager.java","0","0","0","0","0"
"1","PgSQLJdbcScanner.java","0","0","0","0","0"
"1","PgSQLMetadataProvider.java","0","0","0","0","0"
"1","PgSQLTablespace.java","0","0","0","0","0"
"1","PgSQLTestServer.java","0","0","0","0","0"
"1","TestPgSQLEndPointTests.java","0","0","0","0","0"
"1","TestPgSQLJdbcTableSpace.java","446","708","1154","446","446.0"
"1","TestPgSQLMetadataProvider.java","0","0","0","0","0"
"1","TestPgSQLQueryTests.java","0","0","0","0","0"
"1","TestPgSQLSimpleQueryTests.java","0","0","0","0","0"
"1","AnonymousAWSCredentialsProvider.java","0","0","0","0","0"
"1","BasicAWSCredentialsProvider.java","0","0","0","0","0"
"1","S3TableSpace.java","1998","1485","3483","1998","1998.0"
"1","TajoS3Constants.java","0","0","0","0","0"
"1","MockAmazonS3.java","0","0","0","0","0"
"1","MockObjectListing.java","0","0","0","0","0"
"1","MockS3FileSystem.java","0","0","0","0","0"
"1","TestS3TableSpace.java","0","0","0","0","0"
"1","ExampleHttpFileFragment.java","0","0","0","0","0"
"1","ExampleHttpFileFragmentSerde.java","0","0","0","0","0"
"1","ExampleHttpFileTablespace.java","0","0","0","0","0"
"1","ExampleHttpJsonLineReader.java","0","0","0","0","0"
"1","ExampleHttpJsonScanner.java","0","0","0","0","0"
"1","ExampleHttpServerHandler.java","0","0","0","0","0"
"1","ExampleHttpServerInitializer.java","0","0","0","0","0"
"1","ExampleHttpTablespaceTestServer.java","0","0","0","0","0"
"1","TestExampleHttpFileQuery.java","0","0","0","0","0"
"1","AnnotationVisitor.java","0","0","0","0","0"
"1","AnnotationWriter.java","0","0","0","0","0"
"1","Attribute.java","0","0","0","0","0"
"1","ByteVector.java","0","0","0","0","0"
"1","ClassReader.java","0","0","0","0","0"
"1","ClassVisitor.java","0","0","0","0","0"
"1","ClassWriter.java","0","0","0","0","0"
"1","AdviceAdapter.java","0","0","0","0","0"
"1","AnalyzerAdapter.java","145946","289520","435466","145946","145946.0"
"1","CodeSizeEvaluator.java","0","0","0","0","0"
"1","GeneratorAdapter.java","0","0","0","0","0"
"1","InstructionAdapter.java","0","0","0","0","0"
"1","JSRInlinerAdapter.java","145946","289520","435466","145946","145946.0"
"1","LocalVariablesSorter.java","0","0","0","0","0"
"1","Method.java","0","0","0","0","0"
"1","Remapper.java","0","0","0","0","0"
"1","RemappingAnnotationAdapter.java","0","0","0","0","0"
"1","RemappingClassAdapter.java","0","0","0","0","0"
"1","RemappingFieldAdapter.java","0","0","0","0","0"
"1","RemappingMethodAdapter.java","0","0","0","0","0"
"1","RemappingSignatureAdapter.java","0","0","0","0","0"
"1","SerialVersionUIDAdder.java","0","0","0","0","0"
"1","SimpleRemapper.java","0","0","0","0","0"
"1","StaticInitMerger.java","0","0","0","0","0"
"1","TableSwitchGenerator.java","0","0","0","0","0"
"1","TryCatchBlockSorter.java","0","0","0","0","0"
"1","Context.java","0","0","0","0","0"
"1","Edge.java","0","0","0","0","0"
"1","FieldVisitor.java","0","0","0","0","0"
"1","FieldWriter.java","0","0","0","0","0"
"1","Frame.java","0","0","0","0","0"
"1","Handle.java","0","0","0","0","0"
"1","Handler.java","0","0","0","0","0"
"1","Item.java","0","0","0","0","0"
"1","Label.java","0","0","0","0","0"
"1","MethodVisitor.java","0","0","0","0","0"
"1","MethodWriter.java","0","0","0","0","0"
"1","Opcodes.java","0","0","0","0","0"
"1","AnnotationConstantsCollector.java","0","0","0","0","0"
"1","ClassConstantsCollector.java","0","0","0","0","0"
"1","ClassOptimizer.java","0","0","0","0","0"
"1","Constant.java","0","0","0","0","0"
"1","ConstantPool.java","0","0","0","0","0"
"1","FieldConstantsCollector.java","0","0","0","0","0"
"1","JarOptimizer.java","0","0","0","0","0"
"1","MethodConstantsCollector.java","0","0","0","0","0"
"1","MethodOptimizer.java","0","0","0","0","0"
"1","NameMapping.java","0","0","0","0","0"
"1","Shrinker.java","0","0","0","0","0"
"1","SignatureReader.java","0","0","0","0","0"
"1","SignatureVisitor.java","0","0","0","0","0"
"1","SignatureWriter.java","0","0","0","0","0"
"1","AbstractInsnNode.java","0","0","0","0","0"
"1","Analyzer.java","145946","289520","435466","145946","145946.0"
"1","AnalyzerException.java","0","0","0","0","0"
"1","BasicInterpreter.java","0","0","0","0","0"
"1","BasicValue.java","0","0","0","0","0"
"1","BasicVerifier.java","0","0","0","0","0"
"1","Frame.java","0","0","0","0","0"
"1","Interpreter.java","0","0","0","0","0"
"1","SimpleVerifier.java","0","0","0","0","0"
"1","SmallSet.java","0","0","0","0","0"
"1","SourceInterpreter.java","0","0","0","0","0"
"1","SourceValue.java","0","0","0","0","0"
"1","Subroutine.java","0","0","0","0","0"
"1","Value.java","0","0","0","0","0"
"1","AnnotationNode.java","0","0","0","0","0"
"1","ClassNode.java","0","0","0","0","0"
"1","FieldInsnNode.java","0","0","0","0","0"
"1","FieldNode.java","0","0","0","0","0"
"1","FrameNode.java","0","0","0","0","0"
"1","IincInsnNode.java","0","0","0","0","0"
"1","InnerClassNode.java","0","0","0","0","0"
"1","InsnList.java","0","0","0","0","0"
"1","InsnNode.java","0","0","0","0","0"
"1","IntInsnNode.java","0","0","0","0","0"
"1","InvokeDynamicInsnNode.java","0","0","0","0","0"
"1","JumpInsnNode.java","0","0","0","0","0"
"1","LabelNode.java","0","0","0","0","0"
"1","LdcInsnNode.java","0","0","0","0","0"
"1","LineNumberNode.java","0","0","0","0","0"
"1","LocalVariableNode.java","0","0","0","0","0"
"1","LookupSwitchInsnNode.java","0","0","0","0","0"
"1","MethodInsnNode.java","0","0","0","0","0"
"1","MethodNode.java","0","0","0","0","0"
"1","MultiANewArrayInsnNode.java","0","0","0","0","0"
"1","TableSwitchInsnNode.java","0","0","0","0","0"
"1","TryCatchBlockNode.java","0","0","0","0","0"
"1","TypeInsnNode.java","0","0","0","0","0"
"1","VarInsnNode.java","0","0","0","0","0"
"1","Type.java","0","0","0","0","0"
"1","ASMifiable.java","0","0","0","0","0"
"1","ASMifier.java","0","0","0","0","0"
"1","CheckAnnotationAdapter.java","0","0","0","0","0"
"1","CheckClassAdapter.java","0","0","0","0","0"
"1","CheckFieldAdapter.java","0","0","0","0","0"
"1","CheckMethodAdapter.java","145946","289520","435466","145946","145946.0"
"1","CheckSignatureAdapter.java","0","0","0","0","0"
"1","Printer.java","0","0","0","0","0"
"1","Textifiable.java","0","0","0","0","0"
"1","Textifier.java","0","0","0","0","0"
"1","TraceAnnotationVisitor.java","0","0","0","0","0"
"1","TraceClassVisitor.java","0","0","0","0","0"
"1","TraceFieldVisitor.java","0","0","0","0","0"
"1","TraceMethodVisitor.java","0","0","0","0","0"
"1","TraceSignatureVisitor.java","0","0","0","0","0"
"1","ASMContentHandler.java","145946","289520","435466","145946","145946.0"
"1","Processor.java","0","0","0","0","0"
"1","SAXAdapter.java","0","0","0","0","0"
"1","SAXAnnotationAdapter.java","0","0","0","0","0"
"1","SAXClassAdapter.java","0","0","0","0","0"
"1","SAXCodeAdapter.java","0","0","0","0","0"
"1","SAXFieldAdapter.java","0","0","0","0","0"
"1","FadvisedChunkedFile.java","84814","126137","210951","84814","84814.0"
"1","FadvisedFileRegion.java","84814","126137","210951","84814","84814.0"
"1","FileCloseListener.java","144714","284640","429354","144714","144714.0"
"1","TajoPullServerService.java","32712","96804","129516","32712","32712.0"
"2","Aggregation.java","82121","207772","289893","82121","41060.0"
"2","AlterTable.java","145048","281457","426505","145048","72524.0"
"2","AlterTableOpType.java","0","0","0","0","0"
"2","AlterTablespace.java","0","0","0","0","0"
"2","AlterTablespaceSetType.java","0","0","0","0","0"
"2","BetweenPredicate.java","111306","199832","311138","111306","55653.0"
"2","BinaryOperator.java","0","0","0","0","0"
"2","BooleanLiteral.java","0","0","0","0","0"
"2","CaseWhenPredicate.java","82133","191653","273786","82133","41066.0"
"2","CastExpr.java","0","0","0","0","0"
"2","ColumnDefinition.java","115795","131461","247256","115795","57897.0"
"2","ColumnReferenceExpr.java","0","0","0","0","0"
"2","CommonSubquery.java","0","0","0","0","0"
"2","CountRowsFunctionExpr.java","0","0","0","0","0"
"2","CreateDatabase.java","114468","134996","249464","114468","57234.0"
"2","CreateIndex.java","0","0","0","0","0"
"2","CreateTable.java","75249","190718","265967","75249","37624.0"
"2","DataTypeExpr.java","91238","204304","295542","91238","45619.0"
"2","DateLiteral.java","0","0","0","0","0"
"2","DateValue.java","0","0","0","0","0"
"2","DropDatabase.java","114468","134996","249464","114468","57234.0"
"2","DropIndex.java","0","0","0","0","0"
"2","DropTable.java","82559","207722","290281","82559","41279.0"
"2","ExistsPredicate.java","0","0","0","0","0"
"2","Explain.java","152138","291070","443208","152138","76069.0"
"2","Expr.java","82133","191653","273786","82133","41066.0"
"2","ExprVisitor.java","0","0","0","0","0"
"2","FunctionExpr.java","0","0","0","0","0"
"2","GeneralSetFunctionExpr.java","0","0","0","0","0"
"2","Having.java","0","0","0","0","0"
"2","InPredicate.java","82133","191653","273786","82133","41066.0"
"2","Insert.java","82480","385005","467485","82480","41240.0"
"2","IntervalLiteral.java","0","0","0","0","0"
"2","IsNullPredicate.java","0","0","0","0","0"
"2","Join.java","82133","191653","273786","82133","41066.0"
"2","JoinType.java","0","0","0","0","0"
"2","JsonHelper.java","82133","191653","273786","82133","41066.0"
"2","JsonSerializable.java","0","0","0","0","0"
"2","Limit.java","0","0","0","0","0"
"2","LiteralValue.java","0","0","0","0","0"
"2","NamedExpr.java","0","0","0","0","0"
"2","NotExpr.java","0","0","0","0","0"
"2","NullLiteral.java","0","0","0","0","0"
"2","OpType.java","0","0","0","0","0"
"2","PatternMatchPredicate.java","0","0","0","0","0"
"2","Projection.java","82133","191653","273786","82133","41066.0"
"2","QualifiedAsteriskExpr.java","0","0","0","0","0"
"2","Relation.java","77329","389852","467181","77329","38664.0"
"2","RelationList.java","77329","389852","467181","77329","38664.0"
"2","ScalarSubQuery.java","0","0","0","0","0"
"2","Selection.java","0","0","0","0","0"
"2","SetOperation.java","82133","191653","273786","82133","41066.0"
"2","SetSession.java","0","0","0","0","0"
"2","SignedExpr.java","0","0","0","0","0"
"2","SimpleTableSubquery.java","84209","390783","474992","84209","42104.0"
"2","Sort.java","82121","207772","289893","82121","41060.0"
"2","TablePrimarySubQuery.java","84209","390783","474992","84209","42104.0"
"2","TimeLiteral.java","0","0","0","0","0"
"2","TimestampLiteral.java","0","0","0","0","0"
"2","TimeValue.java","125703","176731","302434","125703","62851.0"
"2","TruncateTable.java","0","0","0","0","0"
"2","UnaryOperator.java","0","0","0","0","0"
"2","ValueListExpr.java","82133","191653","273786","82133","41066.0"
"2","Window.java","0","0","0","0","0"
"2","WindowFunctionExpr.java","120710","143085","263795","120710","60355.0"
"2","WindowSpec.java","69654","171066","240720","69654","34827.0"
"2","AlgebraTestingUtil.java","0","0","0","0","0"
"2","TestExpr.java","0","0","0","0","0"
"2","AbstractCatalogClient.java","82348","220509","302857","82348","41174.0"
"2","CatalogClient.java","83576","334269","417845","83576","41788.0"
"2","AlreadyRegisteredURIException.java","0","0","0","0","0"
"2","AlterTableDesc.java","118322","220513","338835","118322","59161.0"
"2","AlterTableType.java","0","0","0","0","0"
"2","AttributeType.java","0","0","0","0","0"
"2","CatalogConstants.java","0","0","0","0","0"
"2","CatalogService.java","141417","282149","423566","141417","70708.0"
"2","CatalogUtil.java","82548","281343","363891","126831","63415.0"
"2","Column.java","82779","315961","398740","82779","41389.0"
"2","DDLBuilder.java","99690","310122","409812","99690","49845.0"
"2","FieldConverter.java","0","0","0","0","0"
"2","FunctionDesc.java","82548","281343","363891","82548","41274.0"
"2","FunctionDescBuilder.java","0","0","0","0","0"
"2","IndexDesc.java","84059","384589","468648","84059","42029.0"
"2","IndexMeta.java","0","0","0","0","0"
"2","CatalogGsonHelper.java","0","0","0","0","0"
"2","FunctionAdapter.java","0","0","0","0","0"
"2","SchemaAdapter.java","0","0","0","0","0"
"2","TableMetaAdapter.java","82589","292140","374729","82589","41294.0"
"2","ListSchemaBuilder.java","0","0","0","0","0"
"2","MetadataProvider.java","110444","136696","247140","110444","55222.0"
"2","NestedPathUtil.java","0","0","0","0","0"
"2","PartitionDesc.java","129979","310376","440355","129979","64989.0"
"2","PartitionMethodDesc.java","0","0","0","0","0"
"2","Schema.java","83578","335331","418909","83578","41789.0"
"2","SchemaBuilder.java","0","0","0","0","0"
"2","SchemaFactory.java","0","0","0","0","0"
"2","SchemaLegacy.java","0","0","0","0","0"
"2","SchemaObject.java","0","0","0","0","0"
"2","SchemaUtil.java","82247","214065","296312","82247","41123.0"
"2","SetSchemaBuilder.java","0","0","0","0","0"
"2","SortSpec.java","84587","423733","508320","84587","42293.0"
"2","ColumnStats.java","74000","276870","350870","74000","37000.0"
"2","Stat.java","0","0","0","0","0"
"2","StatisticsUtil.java","82124","201862","283986","82124","41062.0"
"2","StatSet.java","0","0","0","0","0"
"2","TableStats.java","82129","204350","286479","82129","41064.0"
"2","TableDesc.java","111257","284113","395370","111257","55628.0"
"2","TableMeta.java","110825","208854","319679","110825","55412.0"
"2","TypeConverter.java","0","0","0","0","0"
"2","TypeDesc.java","0","0","0","0","0"
"2","DataTypeUtil.java","0","0","0","0","0"
"2","ClassBaseInvocationDesc.java","0","0","0","0","0"
"2","Function.java","0","0","0","0","0"
"2","FunctionCollection.java","0","0","0","0","0"
"2","FunctionInvocation.java","92487","142115","234602","92487","46243.0"
"2","FunctionSignature.java","93100","145230","238330","93100","46550.0"
"2","FunctionSupplement.java","0","0","0","0","0"
"2","FunctionUtil.java","93100","145230","238330","93100","46550.0"
"2","ScalarFunction.java","0","0","0","0","0"
"2","StaticMethodInvocationDesc.java","0","0","0","0","0"
"2","UDFInvocationDesc.java","1668","4550","6218","1668","834.0"
"2","TestColumnStat.java","0","0","0","0","0"
"2","TestStatisticsUtil.java","0","0","0","0","0"
"2","TestStatSet.java","0","0","0","0","0"
"2","TestTableStat.java","82121","210050","292171","82121","41060.0"
"2","TestCatalogUtil.java","82548","281343","363891","82548","41274.0"
"2","TestColumn.java","0","0","0","0","0"
"2","TestFunctionDesc.java","83614","332037","415651","83614","41807.0"
"2","TestIndexDesc.java","84059","384589","468648","84059","42029.0"
"2","TestKeyValueSet.java","82117","188494","270611","82117","41058.0"
"2","TestSchema.java","82779","315961","398740","82779","41389.0"
"2","TestTableDesc.java","83566","379726","463292","83566","41783.0"
"2","TestTableMeta.java","75228","333817","409045","75228","37614.0"
"2","HCatalogStore.java","0","0","0","0","0"
"2","HiveCatalogStore.java","111608","182005","293613","111608","55804.0"
"2","HiveCatalogStoreClientPool.java","123945","189013","312958","123945","61972.0"
"2","HiveCatalogUtil.java","115321","320368","435689","115321","57660.0"
"2","TestHiveCatalogStore.java","124380","177958","302338","124380","62190.0"
"2","CatalogServer.java","82548","281343","363891","82548","41274.0"
"2","AbstractTableDescriptor.java","0","0","0","0","0"
"2","ClusterTableDescriptor.java","0","0","0","0","0"
"2","ColumnDescriptor.java","0","0","0","0","0"
"2","ColumnsTableDescriptor.java","0","0","0","0","0"
"2","DatabasesTableDescriptor.java","0","0","0","0","0"
"2","IndexesTableDescriptor.java","0","0","0","0","0"
"2","InfoSchemaMetadataDictionary.java","46802","104730","151532","46802","23401.0"
"2","PartitionKeysTableDescriptor.java","0","0","0","0","0"
"2","PartitionsTableDescriptor.java","0","0","0","0","0"
"2","SessionTableDescriptor.java","0","0","0","0","0"
"2","TableDescriptor.java","0","0","0","0","0"
"2","TableOptionsTableDescriptor.java","0","0","0","0","0"
"2","TablespacesTableDescriptor.java","0","0","0","0","0"
"2","TablesTableDescriptor.java","0","0","0","0","0"
"2","TableStatsTableDescriptor.java","0","0","0","0","0"
"2","LinkedMetadataManager.java","109588","120665","230253","109588","54794.0"
"2","LocalCatalogWrapper.java","0","0","0","0","0"
"2","AbstractDBStore.java","114338","131723","246061","114338","57169.0"
"2","CatalogStore.java","82592","294528","377120","82592","41296.0"
"2","DerbyStore.java","101831","285344","387175","101831","50915.0"
"2","MariaDBStore.java","86193","201886","288079","86193","43096.0"
"2","MySQLStore.java","103083","315758","418841","103083","51541.0"
"2","BaseSchema.java","0","0","0","0","0"
"2","DatabaseObject.java","0","0","0","0","0"
"2","DatabaseObjectType.java","0","0","0","0","0"
"2","SchemaPatch.java","0","0","0","0","0"
"2","SQLObject.java","0","0","0","0","0"
"2","StoreObject.java","0","0","0","0","0"
"2","OracleStore.java","40175","49688","89863","40175","20087.0"
"2","PostgreSQLStore.java","39847","49818","89665","39847","19923.0"
"2","XMLCatalogSchemaManager.java","56560","78499","135059","56560","28280.0"
"2","CatalogTestingUtil.java","3578","4807","8385","3578","1789.0"
"2","MiniCatalogServer.java","0","0","0","0","0"
"2","TestXMLCatalogSchemaManager.java","41348","61884","103232","41348","20674.0"
"2","TestCatalog.java","82117","188494","270611","82117","41058.0"
"2","TestCatalogAgainstCaseSensitivity.java","4220","26048","30268","4220","2110.0"
"2","TestCatalogExceptions.java","3451","24548","27999","3451","1725.0"
"2","TestLinkedMetadataManager.java","100438","105248","205686","100438","50219.0"
"2","TajoAdmin.java","123670","172445","296115","123670","61835.0"
"2","TajoDump.java","98598","198075","296673","116090","58045.0"
"2","TajoGetConf.java","0","0","0","0","0"
"2","TajoHAAdmin.java","82345","174806","257151","82345","41172.0"
"2","CliClientParamsFactory.java","0","0","0","0","0"
"2","ConnectDatabaseCommand.java","148691","362497","511188","148691","74345.0"
"2","CopyrightCommand.java","0","0","0","0","0"
"2","DescFunctionCommand.java","129130","258172","387302","129130","64565.0"
"2","DescTableCommand.java","127947","179367","307314","127947","63973.0"
"2","ExecExternalShellCommand.java","119457","140026","259483","119457","59728.0"
"2","ExitCommand.java","0","0","0","0","0"
"2","HdfsCommand.java","0","0","0","0","0"
"2","HelpCommand.java","128046","185421","313467","128046","64023.0"
"2","ListDatabaseCommand.java","0","0","0","0","0"
"2","SetCommand.java","116292","162550","278842","116292","58146.0"
"2","TajoAdminCommand.java","131588","230366","361954","131588","65794.0"
"2","TajoGetConfCommand.java","40262","105070","145332","40262","20131.0"
"2","TajoHAAdminCommand.java","82011","174358","256369","82011","41005.0"
"2","TajoShellCommand.java","128651","194148","322799","128651","64325.0"
"2","UnsetCommand.java","0","0","0","0","0"
"2","VersionCommand.java","128737","248394","377131","128737","64368.0"
"2","DefaultTajoCliOutputFormatter.java","11402","43570","54972","11402","5701.0"
"2","InvalidStatementException.java","0","0","0","0","0"
"2","ParsedResult.java","82118","189853","271971","82118","41059.0"
"2","SimpleParser.java","114424","133167","247591","114424","57212.0"
"2","TajoCli.java","82118","189629","271747","127106","63553.0"
"2","TajoCliOutputFormatter.java","0","0","0","0","0"
"2","TajoFileHistory.java","82703","312530","395233","82703","41351.0"
"2","CatalogAdminClient.java","85925","189379","275304","85925","42962.0"
"2","CatalogAdminClientImpl.java","64266","117883","182149","64266","32133.0"
"2","ClientParameterHelper.java","0","0","0","0","0"
"2","ClientParameters.java","0","0","0","0","0"
"2","DummyServiceTracker.java","19961","43005","62966","19961","9980.0"
"2","InvalidClientSessionException.java","84062","386860","470922","84062","42031.0"
"2","QueryClient.java","5813","15959","21772","5813","2906.0"
"2","QueryClientImpl.java","5813","15959","21772","5813","2906.0"
"2","QueryStatus.java","0","0","0","0","0"
"2","ResultSetUtil.java","123513","274372","397885","123513","61756.0"
"2","SessionConnection.java","10010","25416","35426","10010","5005.0"
"2","TajoClient.java","97990","103158","201148","97990","48995.0"
"2","TajoClientImpl.java","5813","15959","21772","5813","2906.0"
"2","TajoClientUtil.java","10010","25416","35426","10010","5005.0"
"2","ClientDelegate.java","0","0","0","0","0"
"2","ClientDelegateFactory.java","0","0","0","0","0"
"2","ClientUtil.java","0","0","0","0","0"
"2","ClientConnectionException.java","0","0","0","0","0"
"2","ClientUnableToConnectException.java","0","0","0","0","0"
"2","FutureListener.java","0","0","0","0","0"
"2","LegacyClientDelegate.java","3446","5585","9031","3446","1723.0"
"2","QueryFuture.java","0","0","0","0","0"
"2","QueryState.java","0","0","0","0","0"
"2","ServiceDiscovery.java","0","0","0","0","0"
"2","TajoClient.java","97990","103158","201148","97990","48995.0"
"2","FetchResultSet.java","83970","122968","206938","83970","41985.0"
"2","MetaDataTuple.java","110950","179189","290139","110950","55475.0"
"2","TajoMemoryResultSet.java","149253","281327","430580","149253","74626.0"
"2","TajoMetaDataResultSet.java","113969","179575","293544","113969","56984.0"
"2","TajoResultSetBase.java","113990","191790","305780","113990","56995.0"
"2","TajoResultSetMetaData.java","114598","265882","380480","114598","57299.0"
"2","TajoSQLException.java","0","0","0","0","0"
"2","WaitingResultSet.java","0","0","0","0","0"
"2","RowStoreUtil.java","82247","213856","296103","121041","60520.0"
"2","TableExample.java","0","0","0","0","0"
"2","TajoClientAsyncExample.java","0","0","0","0","0"
"2","TajoClientExample.java","0","0","0","0","0"
"2","BackendTestingUtil.java","90361","388943","479304","90361","45180.0"
"2","CatalogTestingUtil.java","3578","4807","8385","3578","1789.0"
"2","HBaseTestClusterUtil.java","24","192","216","24","12.0"
"2","IntegrationTest.java","0","0","0","0","0"
"2","LocalTajoTestingUtility.java","90818","278508","369326","90818","45409.0"
"2","NamedTest.java","0","0","0","0","0"
"2","QueryTestCaseBase.java","123499","168920","292419","123499","61749.0"
"2","TajoTestingCluster.java","82129","205939","288068","82129","41064.0"
"2","TpchTestBase.java","84219","392901","477120","84219","42109.0"
"2","NotNull.java","0","0","0","0","0"
"2","NotThreadSafe.java","0","0","0","0","0"
"2","Nullable.java","0","0","0","0","0"
"2","ThreadSafe.java","0","0","0","0","0"
"2","Assert.java","0","0","0","0","0"
"2","UserRoleInfo.java","0","0","0","0","0"
"2","BuiltinStorages.java","0","0","0","0","0"
"2","ProtoObject.java","0","0","0","0","0"
"2","Sleeper.java","0","0","0","0","0"
"2","IPv4.java","0","0","0","0","0"
"2","TajoTypeUtil.java","0","0","0","0","0"
"2","TimeRange.java","0","0","0","0","0"
"2","TajoConf.java","82134","200335","282469","82134","41067.0"
"2","ConfigKey.java","0","0","0","0","0"
"2","AnyDatum.java","0","0","0","0","0"
"2","BitDatum.java","0","0","0","0","0"
"2","BlobDatum.java","83614","332037","415651","83614","41807.0"
"2","BooleanDatum.java","0","0","0","0","0"
"2","CharDatum.java","82390","271489","353879","82390","41195.0"
"2","DateDatum.java","121562","186809","308371","128046","64023.0"
"2","Datum.java","126584","201400","327984","126584","63292.0"
"2","DatumFactory.java","75497","198596","274093","125480","62740.0"
"2","Float4Datum.java","82124","201862","283986","126415","63207.0"
"2","Float8Datum.java","82124","201862","283986","126415","63207.0"
"2","Int2Datum.java","82124","201862","283986","126415","63207.0"
"2","Int4Datum.java","82124","201862","283986","126415","63207.0"
"2","Int8Datum.java","82124","201862","283986","126415","63207.0"
"2","IntervalDatum.java","2925","16860","19785","2925","1462.0"
"2","NullDatum.java","82390","271489","353879","82390","41195.0"
"2","NumericDatum.java","0","0","0","0","0"
"2","AbstractCharBasedFormatter.java","0","0","0","0","0"
"2","ProtobufFormatter.java","0","0","0","0","0"
"2","ProtobufJsonFormat.java","0","0","0","0","0"
"2","TextUtils.java","96263","306594","402857","96263","48131.0"
"2","ProtobufDatum.java","0","0","0","0","0"
"2","ProtobufDatumFactory.java","98160","405035","503195","98160","49080.0"
"2","TextDatum.java","82254","214654","296908","82254","41127.0"
"2","TimeDatum.java","121711","186609","308320","125375","62687.0"
"2","TimestampDatum.java","121399","187728","309127","128046","64023.0"
"2","AmbiguousColumnException.java","0","0","0","0","0"
"2","AmbiguousFunctionException.java","3446","5585","9031","3446","1723.0"
"2","AmbiguousPartitionDirectoryExistException.java","24737","27752","52489","24737","12368.0"
"2","AmbiguousTableException.java","0","0","0","0","0"
"2","CannotDropCurrentDatabaseException.java","84547","420781","505328","84547","42273.0"
"2","CatalogUpgradeRequiredException.java","84208","389145","473353","84208","42104.0"
"2","DataTypeMismatchException.java","84062","386860","470922","84062","42031.0"
"2","DefaultTajoException.java","84208","389145","473353","84208","42104.0"
"2","DividedByZeroException.java","84547","420781","505328","84547","42273.0"
"2","DuplicateColumnException.java","83983","380705","464688","83983","41991.0"
"2","DuplicateDatabaseException.java","83983","380705","464688","83983","41991.0"
"2","DuplicateFunctionException.java","84062","386860","470922","84062","42031.0"
"2","DuplicateIndexException.java","84208","389145","473353","84208","42104.0"
"2","DuplicatePartitionException.java","84208","389145","473353","84208","42104.0"
"2","DuplicateTableException.java","84208","389145","473353","84208","42104.0"
"2","DuplicateTablespaceException.java","83983","380705","464688","83983","41991.0"
"2","ErrorMessages.java","1011","1614","2625","1011","505.0"
"2","ErrorUtil.java","0","0","0","0","0"
"2","ExceptionUtil.java","11470","19685","31155","11470","5735.0"
"2","InsufficientPrivilegeException.java","3254","3963","7217","3254","1627.0"
"2","InvalidAddressException.java","0","0","0","0","0"
"2","InvalidDataTypeException.java","114440","374153","488593","114440","57220.0"
"2","InvalidInputsForCrossJoin.java","0","0","0","0","0"
"2","InvalidNameException.java","83983","380705","464688","83983","41991.0"
"2","InvalidOperationException.java","0","0","0","0","0"
"2","InvalidSessionException.java","84062","386860","470922","84062","42031.0"
"2","InvalidSessionVariableException.java","84547","420781","505328","84547","42273.0"
"2","InvalidTablePropertyException.java","84062","386860","470922","84062","42031.0"
"2","InvalidURLException.java","84547","420781","505328","84547","42273.0"
"2","InvalidValueForCastException.java","84377","410628","495005","84377","42188.0"
"2","LMDNoMatchedDatatypeException.java","84062","386860","470922","84062","42031.0"
"2","MetadataConnectionException.java","83983","380705","464688","83983","41991.0"
"2","MissingTablePropertyException.java","84062","386860","470922","84062","42031.0"
"2","NoSuchSessionVariableException.java","83983","380705","464688","83983","41991.0"
"2","NotImplementedException.java","0","0","0","0","0"
"2","QueryFailedException.java","84062","386860","470922","84062","42031.0"
"2","QueryKilledException.java","84062","386860","470922","84062","42031.0"
"2","QueryNotFoundException.java","84062","386860","470922","84062","42031.0"
"2","ReturnStateUtil.java","7595","11403","18998","7595","3797.0"
"2","SQLExceptionUtil.java","8785","14861","23646","8785","4392.0"
"2","SQLSyntaxError.java","0","0","0","0","0"
"2","TajoError.java","8785","14861","23646","8785","4392.0"
"2","TajoException.java","8785","14861","23646","8785","4392.0"
"2","TajoInternalError.java","114440","374153","488593","114440","57220.0"
"2","TajoRuntimeException.java","1011","1614","2625","1011","505.0"
"2","TooLargeInputForCrossJoinException.java","0","0","0","0","0"
"2","UnavailableTableLocationException.java","84062","386860","470922","84062","42031.0"
"2","UndefinedColumnException.java","83983","380705","464688","83983","41991.0"
"2","UndefinedDatabaseException.java","83983","380705","464688","83983","41991.0"
"2","UndefinedFunctionException.java","84062","386860","470922","84062","42031.0"
"2","UndefinedIndexException.java","83983","380705","464688","83983","41991.0"
"2","UndefinedOperatorException.java","114440","374153","488593","114440","57220.0"
"2","UndefinedPartitionException.java","0","0","0","0","0"
"2","UndefinedPartitionKeyException.java","24737","27752","52489","24737","12368.0"
"2","UndefinedPartitionMethodException.java","24737","27752","52489","24737","12368.0"
"2","UndefinedTableException.java","83983","380705","464688","83983","41991.0"
"2","UndefinedTablespaceException.java","83983","380705","464688","83983","41991.0"
"2","UndefinedTablespaceHandlerException.java","0","0","0","0","0"
"2","UnknownDataFormatException.java","84062","386860","470922","84062","42031.0"
"2","UnremovableTablePropertyException.java","0","0","0","0","0"
"2","UnsupportedCatalogStore.java","0","0","0","0","0"
"2","UnsupportedDataTypeException.java","84208","389145","473353","84208","42104.0"
"2","UnsupportedException.java","0","0","0","0","0"
"2","ValueOutOfRangeException.java","0","0","0","0","0"
"2","ValueTooLongForTypeCharactersException.java","0","0","0","0","0"
"2","ExecutionBlockId.java","0","0","0","0","0"
"2","HAConstants.java","0","0","0","0","0"
"2","ClassNameSerializer.java","82548","281343","363891","82548","41274.0"
"2","CommonGsonHelper.java","0","0","0","0","0"
"2","DataTypeAdapter.java","0","0","0","0","0"
"2","DatumAdapter.java","82589","292140","374729","125276","62638.0"
"2","GsonHelper.java","0","0","0","0","0"
"2","GsonObject.java","0","0","0","0","0"
"2","GsonSerDerAdapter.java","0","0","0","0","0"
"2","PathSerializer.java","0","0","0","0","0"
"2","TimeZoneGsonSerdeAdapter.java","0","0","0","0","0"
"2","TypeAdapter.java","0","0","0","0","0"
"2","OverridableConf.java","463","3653","4116","463","231.0"
"2","QueryId.java","80935","376785","457720","80935","40467.0"
"2","QueryIdFactory.java","79968","304550","384518","79968","39984.0"
"2","QueryVars.java","0","0","0","0","0"
"2","BaseRuleProvider.java","0","0","0","0","0"
"2","CheckHadoopRuntimeVersionRule.java","0","0","0","0","0"
"2","TajoConfValidationRule.java","0","0","0","0","0"
"2","EvaluationContext.java","0","0","0","0","0"
"2","EvaluationFailedException.java","0","0","0","0","0"
"2","EvaluationResult.java","0","0","0","0","0"
"2","SelfDiagnosisRule.java","0","0","0","0","0"
"2","SelfDiagnosisRuleDefinition.java","0","0","0","0","0"
"2","SelfDiagnosisRuleEngine.java","12","123","135","12","6.0"
"2","SelfDiagnosisRuleProvider.java","0","0","0","0","0"
"2","SelfDiagnosisRuleSession.java","53844","69782","123626","53844","26922.0"
"2","SelfDiagnosisRuleVisibility.java","0","0","0","0","0"
"2","ANSISQLIdentifierPolicy.java","0","0","0","0","0"
"2","Field.java","0","0","0","0","0"
"2","Identifier.java","0","0","0","0","0"
"2","IdentifierPolicy.java","0","0","0","0","0"
"2","IdentifierUtil.java","0","0","0","0","0"
"2","package-info.java","0","0","0","0","0"
"2","PgSQLIdentifierPolicy.java","0","0","0","0","0"
"2","QualifiedIdentifier.java","0","0","0","0","0"
"2","Schema.java","83578","335331","418909","83578","41789.0"
"2","TajoIdentifierPolicy.java","0","0","0","0","0"
"2","BaseServiceTracker.java","19961","43005","62966","19961","9980.0"
"2","HAServiceTracker.java","19961","43005","62966","19961","9980.0"
"2","ServiceTracker.java","81690","172148","253838","81690","40845.0"
"2","ServiceTrackerException.java","0","0","0","0","0"
"2","ServiceTrackerFactory.java","0","0","0","0","0"
"2","TajoMasterInfo.java","0","0","0","0","0"
"2","SessionVars.java","35320","98866","134186","35320","17660.0"
"2","BufferPool.java","66502","110968","177470","66502","33251.0"
"2","EmptyTuple.java","78262","166673","244935","78262","39131.0"
"2","NullTuple.java","13886","55100","68986","13886","6943.0"
"2","StorageConstants.java","127970","223608","351578","127970","63985.0"
"2","Tuple.java","82577","284823","367400","82577","41288.0"
"2","VTuple.java","82390","271489","353879","82390","41195.0"
"2","TajoConstants.java","84547","420781","505328","84547","42273.0"
"2","TaskAttemptId.java","79968","304550","384518","79968","39984.0"
"2","TaskId.java","79968","304550","384518","79968","39984.0"
"2","BaseTupleBuilder.java","7397","11849","19246","7397","3698.0"
"2","CompactRowBlockWriter.java","1906","2605","4511","1906","953.0"
"2","DirectBufTuple.java","120694","228204","348898","120694","60347.0"
"2","FixedSizeLimitSpec.java","0","0","0","0","0"
"2","HeapRowBlockReader.java","0","0","0","0","0"
"2","HeapTuple.java","76797","166919","243716","76797","38398.0"
"2","MemoryBlock.java","0","0","0","0","0"
"2","MemoryRowBlock.java","13995","43228","57223","13995","6997.0"
"2","OffHeapRowBlockReader.java","0","0","0","0","0"
"2","OffHeapRowBlockUtils.java","13995","43228","57223","13995","6997.0"
"2","OffHeapRowBlockWriter.java","120694","228204","348898","120694","60347.0"
"2","OffHeapRowWriter.java","0","0","0","0","0"
"2","ResizableLimitSpec.java","127071","263814","390885","127071","63535.0"
"2","ResizableMemoryBlock.java","15702","45634","61336","15702","7851.0"
"2","RowBlock.java","13995","43228","57223","13995","6997.0"
"2","RowWriter.java","120694","228204","348898","120694","60347.0"
"2","UnSafeTuple.java","1712","9416","11128","1712","856.0"
"2","UnSafeTupleBytesComparator.java","0","0","0","0","0"
"2","UnSafeTupleList.java","0","0","0","0","0"
"2","ZeroCopyTuple.java","0","0","0","0","0"
"2","RowBlockReader.java","0","0","0","0","0"
"2","TupleBuilder.java","0","0","0","0","0"
"2","Any.java","0","0","0","0","0"
"2","Array.java","0","0","0","0","0"
"2","Bit.java","0","0","0","0","0"
"2","Blob.java","0","0","0","0","0"
"2","Bool.java","0","0","0","0","0"
"2","Char.java","0","0","0","0","0"
"2","Date.java","0","0","0","0","0"
"2","Float4.java","0","0","0","0","0"
"2","Float8.java","0","0","0","0","0"
"2","Int1.java","0","0","0","0","0"
"2","Int2.java","0","0","0","0","0"
"2","Int4.java","0","0","0","0","0"
"2","Int8.java","0","0","0","0","0"
"2","Interval.java","0","0","0","0","0"
"2","Map.java","0","0","0","0","0"
"2","Null.java","0","0","0","0","0"
"2","Numeric.java","0","0","0","0","0"
"2","package-info.java","0","0","0","0","0"
"2","Protobuf.java","0","0","0","0","0"
"2","Record.java","0","0","0","0","0"
"2","Text.java","0","0","0","0","0"
"2","Time.java","0","0","0","0","0"
"2","Timestamp.java","0","0","0","0","0"
"2","Type.java","0","0","0","0","0"
"2","TypeFactory.java","0","0","0","0","0"
"2","TypeParamterizedType.java","0","0","0","0","0"
"2","TypeProtobufEncoder.java","0","0","0","0","0"
"2","TypeStringEncoder.java","0","0","0","0","0"
"2","TypeVisitor.java","0","0","0","0","0"
"2","ValueParamterizedType.java","0","0","0","0","0"
"2","Varchar.java","0","0","0","0","0"
"2","StorageUnit.java","0","0","0","0","0"
"2","TimeUnit.java","0","0","0","0","0"
"2","BasicFuture.java","0","0","0","0","0"
"2","BitArray.java","0","0","0","0","0"
"2","Bytes.java","82247","213251","295498","82247","41123.0"
"2","BytesUtils.java","738","3266","4004","738","369.0"
"2","ClassSize.java","0","0","0","0","0"
"2","ClassUtil.java","129084","258735","387819","129084","64542.0"
"2","CommonTestingUtil.java","82390","271489","353879","82390","41195.0"
"2","CompressionUtil.java","0","0","0","0","0"
"2","DateTimeConstants.java","44074","133165","177239","44074","22037.0"
"2","DateTimeFormat.java","5779","8637","14416","5779","2889.0"
"2","DateTimeUtil.java","984","4434","5418","984","492.0"
"2","TimeMeta.java","80714","193536","274250","80714","40357.0"
"2","Deallocatable.java","0","0","0","0","0"
"2","FileUtil.java","83603","321083","404686","83603","41801.0"
"2","DirectedGraph.java","0","0","0","0","0"
"2","DirectedGraphCursor.java","0","0","0","0","0"
"2","DirectedGraphVisitor.java","0","0","0","0","0"
"2","Graph.java","0","0","0","0","0"
"2","SimpleDirectedGraph.java","92496","378963","471459","92496","46248.0"
"2","SimpleUndirectedGraph.java","0","0","0","0","0"
"2","UndirectedGraph.java","0","0","0","0","0"
"2","JarUtil.java","0","0","0","0","0"
"2","JavaResourceUtil.java","0","0","0","0","0"
"2","KeyValueSet.java","82117","188494","270611","82117","41058.0"
"2","MurmurHash.java","0","0","0","0","0"
"2","NetUtils.java","0","0","0","0","0"
"2","NumberUtil.java","88828","210463","299291","88828","44414.0"
"2","Pair.java","116384","167968","284352","116384","58192.0"
"2","PlatformUtil.java","0","0","0","0","0"
"2","ProtoUtil.java","128534","252668","381202","128534","64267.0"
"2","ReflectionUtil.java","82701","309764","392465","82701","41350.0"
"2","ShutdownHookManager.java","0","0","0","0","0"
"2","SizeOf.java","0","0","0","0","0"
"2","StringUtils.java","11980","29413","41393","116144","58072.0"
"2","TajoIdUtils.java","0","0","0","0","0"
"2","TUtil.java","82701","309764","392465","82701","41350.0"
"2","UnsafeComparer.java","0","0","0","0","0"
"2","UnsafeUtil.java","66053","114702","180755","66053","33026.0"
"2","UriUtil.java","0","0","0","0","0"
"2","VersionInfo.java","42415","134981","177396","42415","21207.0"
"2","AbstractValidator.java","0","0","0","0","0"
"2","BooleanValidator.java","0","0","0","0","0"
"2","ClassValidator.java","0","0","0","0","0"
"2","ConstraintViolation.java","0","0","0","0","0"
"2","ConstraintViolationException.java","53584","85811","139395","53584","26792.0"
"2","GroupValidator.java","0","0","0","0","0"
"2","JavaStringValidator.java","0","0","0","0","0"
"2","LengthValidator.java","0","0","0","0","0"
"2","MaxValidator.java","0","0","0","0","0"
"2","MinValidator.java","0","0","0","0","0"
"2","NetworkAddressValidator.java","0","0","0","0","0"
"2","NotNullValidator.java","0","0","0","0","0"
"2","PathListValidator.java","0","0","0","0","0"
"2","PathValidator.java","0","0","0","0","0"
"2","PatternValidator.java","0","0","0","0","0"
"2","RangeValidator.java","0","0","0","0","0"
"2","ShellVariableValidator.java","0","0","0","0","0"
"2","Validator.java","0","0","0","0","0"
"2","Validators.java","12862","29262","42124","12862","6431.0"
"2","TestIPv4.java","0","0","0","0","0"
"2","TestTimeRange.java","0","0","0","0","0"
"2","TestProtobufDatum.java","0","0","0","0","0"
"2","TestTextUtils.java","0","0","0","0","0"
"2","TestArithmeticOperator.java","0","0","0","0","0"
"2","TestBitDatum.java","0","0","0","0","0"
"2","TestBoolDatum.java","0","0","0","0","0"
"2","TestBytesDatum.java","0","0","0","0","0"
"2","TestCharDatum.java","0","0","0","0","0"
"2","TestDateDatum.java","122723","279611","402334","122723","61361.0"
"2","TestDatum.java","0","0","0","0","0"
"2","TestDatumFactory.java","0","0","0","0","0"
"2","TestFloat8Datum.java","0","0","0","0","0"
"2","TestFloatDatum.java","0","0","0","0","0"
"2","TestInt2Datum.java","0","0","0","0","0"
"2","TestInt4Datum.java","0","0","0","0","0"
"2","TestInt8Datum.java","0","0","0","0","0"
"2","TestIntervalDatum.java","2925","16860","19785","2925","1462.0"
"2","TestTextDatum.java","82346","218529","300875","82346","41173.0"
"2","TestTimeDatum.java","0","0","0","0","0"
"2","TestTimestampDatum.java","121399","187728","309127","121399","60699.0"
"2","TestRuleEngine.java","0","0","0","0","0"
"2","TestRuleSession.java","0","0","0","0","0"
"2","TestANSISQLIdentifierPolicy.java","0","0","0","0","0"
"2","TestIdentifier.java","0","0","0","0","0"
"2","TestSchema.java","82779","315961","398740","82779","41389.0"
"2","TestTajoIdentifierPolicy.java","0","0","0","0","0"
"2","TestHeapTuple.java","0","0","0","0","0"
"2","TestMemoryRowBlock.java","120694","228204","348898","120694","60347.0"
"2","TestResizableSpec.java","0","0","0","0","0"
"2","TestUnSafeTupleBytesComparator.java","0","0","0","0","0"
"2","TestBaseTupleBuilder.java","0","0","0","0","0"
"2","TestType.java","0","0","0","0","0"
"2","TestTypeEncoder.java","0","0","0","0","0"
"2","TestTypeProtobufEncoder.java","0","0","0","0","0"
"2","TestTypeStringEncoder.java","0","0","0","0","0"
"2","TestSimpleDirectedGraph.java","90841","275983","366824","90841","45420.0"
"2","TestSimpleUndirectedGraph.java","99626","272785","372411","99626","49813.0"
"2","TestBitArrayTest.java","0","0","0","0","0"
"2","TestDateTimeFormat.java","0","0","0","0","0"
"2","TestDateTimeUtil.java","44074","133165","177239","44074","22037.0"
"2","TestNumberUtil.java","0","0","0","0","0"
"2","TestStringUtil.java","0","0","0","0","0"
"2","TestUriUtil.java","0","0","0","0","0"
"2","TestValidators.java","12862","29262","42124","12862","6431.0"
"2","BenchmarkSet.java","82709","311328","394037","82709","41354.0"
"2","Driver.java","0","0","0","0","0"
"2","SimpleQuery.java","0","0","0","0","0"
"2","TPCH.java","82389","274013","356402","82389","41194.0"
"2","CaseWhenEmitter.java","3456","13152","16608","3456","1728.0"
"2","CaseWhenSwitchGenerator.java","0","0","0","0","0"
"2","CodeGenUtils.java","0","0","0","0","0"
"2","CompilationError.java","90651","268645","359296","90651","45325.0"
"2","EvalCodeEmitter.java","0","0","0","0","0"
"2","EvalCodeGenContext.java","0","0","0","0","0"
"2","EvalCodeGenerator.java","3456","13152","16608","3456","1728.0"
"2","ExecutorPreCompiler.java","34831","41979","76810","34831","17415.0"
"2","LegacyFunctionBindingEmitter.java","0","0","0","0","0"
"2","ScalarFunctionBindingEmitter.java","0","0","0","0","0"
"2","TajoClassLoader.java","90651","268645","359296","90651","45325.0"
"2","TajoGeneratorAdapter.java","3456","13152","16608","3456","1728.0"
"2","VariablesPreBuilder.java","0","0","0","0","0"
"2","RangeOverflowException.java","82324","215856","298180","82324","41162.0"
"2","Description.java","0","0","0","0","0"
"2","ParamOptionTypes.java","0","0","0","0","0"
"2","ParamTypes.java","0","0","0","0","0"
"2","AvgDouble.java","82704","312460","395164","82704","41352.0"
"2","AvgFloat.java","130887","291499","422386","130887","65443.0"
"2","AvgInt.java","130887","291499","422386","130887","65443.0"
"2","AvgLong.java","82704","312460","395164","82704","41352.0"
"2","Coalesce.java","0","0","0","0","0"
"2","CoalesceBoolean.java","0","0","0","0","0"
"2","CoalesceDate.java","0","0","0","0","0"
"2","CoalesceDouble.java","0","0","0","0","0"
"2","CoalesceLong.java","0","0","0","0","0"
"2","CoalesceString.java","0","0","0","0","0"
"2","CoalesceTime.java","0","0","0","0","0"
"2","CoalesceTimestamp.java","0","0","0","0","0"
"2","Corr.java","0","0","0","0","0"
"2","CountRows.java","0","0","0","0","0"
"2","CountValue.java","0","0","0","0","0"
"2","CountValueDistinct.java","92828","372989","465817","92828","46414.0"
"2","Date.java","0","0","0","0","0"
"2","LastValue.java","0","0","0","0","0"
"2","LastValueDate.java","0","0","0","0","0"
"2","LastValueDouble.java","0","0","0","0","0"
"2","LastValueFloat.java","0","0","0","0","0"
"2","LastValueInt.java","0","0","0","0","0"
"2","LastValueLong.java","0","0","0","0","0"
"2","LastValueString.java","0","0","0","0","0"
"2","LastValueTime.java","0","0","0","0","0"
"2","LastValueTimestamp.java","0","0","0","0","0"
"2","Lead.java","100026","202719","302745","100026","50013.0"
"2","LeadDate.java","0","0","0","0","0"
"2","LeadDouble.java","0","0","0","0","0"
"2","LeadFloat.java","0","0","0","0","0"
"2","LeadInt.java","0","0","0","0","0"
"2","LeadLong.java","0","0","0","0","0"
"2","LeadString.java","0","0","0","0","0"
"2","LeadTime.java","0","0","0","0","0"
"2","LeadTimestamp.java","0","0","0","0","0"
"2","Max.java","0","0","0","0","0"
"2","MaxDate.java","0","0","0","0","0"
"2","MaxDouble.java","130887","291499","422386","130887","65443.0"
"2","MaxFloat.java","130887","291499","422386","130887","65443.0"
"2","MaxInt.java","130887","291499","422386","130887","65443.0"
"2","MaxLong.java","0","0","0","0","0"
"2","MaxString.java","131661","290357","422018","131661","65830.0"
"2","MaxTime.java","0","0","0","0","0"
"2","MaxTimestamp.java","0","0","0","0","0"
"2","Min.java","0","0","0","0","0"
"2","MinDate.java","0","0","0","0","0"
"2","MinDouble.java","130887","291499","422386","130887","65443.0"
"2","MinFloat.java","130887","291499","422386","130887","65443.0"
"2","MinInt.java","130887","291499","422386","130887","65443.0"
"2","MinLong.java","0","0","0","0","0"
"2","MinString.java","130887","291499","422386","130887","65443.0"
"2","MinTime.java","0","0","0","0","0"
"2","MinTimestamp.java","0","0","0","0","0"
"2","RandomInt.java","0","0","0","0","0"
"2","Sleep.java","0","0","0","0","0"
"2","StdDevPop.java","7313","12999","20312","7313","3656.0"
"2","StdDevPopDouble.java","0","0","0","0","0"
"2","StdDevPopFloat.java","0","0","0","0","0"
"2","StdDevPopInt.java","0","0","0","0","0"
"2","StdDevPopLong.java","0","0","0","0","0"
"2","StdDevSamp.java","7313","12999","20312","7313","3656.0"
"2","StdDevSampDouble.java","0","0","0","0","0"
"2","StdDevSampFloat.java","0","0","0","0","0"
"2","StdDevSampInt.java","0","0","0","0","0"
"2","StdDevSampLong.java","0","0","0","0","0"
"2","StringAgg.java","0","0","0","0","0"
"2","SumDouble.java","82704","312460","395164","82704","41352.0"
"2","SumDoubleDistinct.java","0","0","0","0","0"
"2","SumFloat.java","130887","291499","422386","130887","65443.0"
"2","SumFloatDistinct.java","0","0","0","0","0"
"2","SumInt.java","0","0","0","0","0"
"2","SumIntDistinct.java","0","0","0","0","0"
"2","SumLong.java","82704","312460","395164","82704","41352.0"
"2","SumLongDistinct.java","0","0","0","0","0"
"2","Variance.java","0","0","0","0","0"
"2","VarPop.java","0","0","0","0","0"
"2","VarPopDouble.java","0","0","0","0","0"
"2","VarPopFloat.java","0","0","0","0","0"
"2","VarPopInt.java","0","0","0","0","0"
"2","VarPopLong.java","0","0","0","0","0"
"2","VarSamp.java","0","0","0","0","0"
"2","VarSampDouble.java","0","0","0","0","0"
"2","VarSampFloat.java","0","0","0","0","0"
"2","VarSampInt.java","0","0","0","0","0"
"2","VarSampLong.java","0","0","0","0","0"
"2","AddDays.java","0","0","0","0","0"
"2","AddMonths.java","0","0","0","0","0"
"2","CurrentDate.java","47420","138991","186411","47420","23710.0"
"2","CurrentTime.java","82129","203040","285169","82129","41064.0"
"2","DatePartFromDate.java","136406","358031","494437","136406","68203.0"
"2","DatePartFromTime.java","128837","176295","305132","128837","64418.0"
"2","DatePartFromTimestamp.java","128837","176295","305132","128837","64418.0"
"2","DateTimePartFromUnixTimestamp.java","115250","143880","259130","115250","57625.0"
"2","NowTimestamp.java","82129","203040","285169","82129","41064.0"
"2","ToCharTimestamp.java","121399","187728","309127","121399","60699.0"
"2","ToDate.java","2925","16860","19785","2925","1462.0"
"2","ToTimestampInt.java","121399","187728","309127","121399","60699.0"
"2","ToTimestampText.java","47149","141430","188579","47149","23574.0"
"2","FailFunction.java","0","0","0","0","0"
"2","FunctionLoader.java","92487","142115","234602","92487","46243.0"
"2","BlobToIPstr.java","0","0","0","0","0"
"2","GeoIPCountryBlob.java","0","0","0","0","0"
"2","GeoIPCountryInt.java","0","0","0","0","0"
"2","GeoIPCountryText.java","0","0","0","0","0"
"2","GeoIPInCountryBlob.java","0","0","0","0","0"
"2","GeoIPInCountryInt.java","0","0","0","0","0"
"2","GeoIPInCountryText.java","144213","354057","498270","144213","72106.0"
"2","IntToIPstr.java","0","0","0","0","0"
"2","IPstrToBlob.java","0","0","0","0","0"
"2","IPstrToInt.java","0","0","0","0","0"
"2","HiveFunctionLoader.java","0","0","0","0","0"
"2","JsonArrayContains.java","0","0","0","0","0"
"2","JsonArrayGet.java","0","0","0","0","0"
"2","JsonArrayLength.java","0","0","0","0","0"
"2","JsonExtractPathText.java","0","0","0","0","0"
"2","ScalarJsonFunction.java","0","0","0","0","0"
"2","AbsDouble.java","0","0","0","0","0"
"2","AbsFloat.java","0","0","0","0","0"
"2","AbsInt.java","0","0","0","0","0"
"2","AbsLong.java","0","0","0","0","0"
"2","Acos.java","0","0","0","0","0"
"2","Asin.java","0","0","0","0","0"
"2","Atan.java","0","0","0","0","0"
"2","Atan2.java","0","0","0","0","0"
"2","Cbrt.java","0","0","0","0","0"
"2","Ceil.java","0","0","0","0","0"
"2","Cos.java","0","0","0","0","0"
"2","Degrees.java","0","0","0","0","0"
"2","Div.java","122913","366311","489224","122913","61456.0"
"2","Exp.java","0","0","0","0","0"
"2","Floor.java","0","0","0","0","0"
"2","MathFunctions.java","0","0","0","0","0"
"2","Mod.java","122913","366311","489224","122913","61456.0"
"2","Pi.java","0","0","0","0","0"
"2","Pow.java","0","0","0","0","0"
"2","Radians.java","0","0","0","0","0"
"2","Round.java","115087","203003","318090","115087","57543.0"
"2","RoundFloat8.java","9275","33794","43069","9275","4637.0"
"2","Sign.java","0","0","0","0","0"
"2","Sin.java","0","0","0","0","0"
"2","Sqrt.java","0","0","0","0","0"
"2","Tan.java","0","0","0","0","0"
"2","Ascii.java","122457","366311","488768","122457","61228.0"
"2","BitLength.java","118277","366469","484746","118277","59138.0"
"2","BTrim.java","100367","272785","373152","100367","50183.0"
"2","CharLength.java","113915","369562","483477","113915","56957.0"
"2","Chr.java","125108","366188","491296","125108","62554.0"
"2","Concat.java","115885","154502","270387","115885","57942.0"
"2","Concat_ws.java","115974","154502","270476","115974","57987.0"
"2","Decode.java","130820","365207","496027","130820","65410.0"
"2","Digest.java","134921","358041","492962","134921","67460.0"
"2","Encode.java","130820","365207","496027","130820","65410.0"
"2","FindInSet.java","130842","364340","495182","130842","65421.0"
"2","HexStringConverter.java","0","0","0","0","0"
"2","InitCap.java","121911","366311","488222","121911","60955.0"
"2","Left.java","119990","366462","486452","119990","59995.0"
"2","Length.java","0","0","0","0","0"
"2","Locate.java","123701","366301","490002","123701","61850.0"
"2","Lower.java","0","0","0","0","0"
"2","Lpad.java","119482","267061","386543","119482","59741.0"
"2","LTrim.java","100367","272785","373152","100367","50183.0"
"2","Md5.java","118960","366467","485427","118960","59480.0"
"2","OctetLength.java","0","0","0","0","0"
"2","QuoteIdent.java","0","0","0","0","0"
"2","RegexpReplace.java","92073","291843","383916","92073","46036.0"
"2","Repeat.java","120224","366462","486686","120224","60112.0"
"2","Reverse.java","118885","366467","485352","118885","59442.0"
"2","Right.java","119990","366462","486452","119990","59995.0"
"2","Rpad.java","119576","267061","386637","119576","59788.0"
"2","RTrim.java","100367","272785","373152","100367","50183.0"
"2","SplitPart.java","92866","373201","466067","92866","46433.0"
"2","StrPos.java","118818","366467","485285","118818","59409.0"
"2","StrPosb.java","118818","366467","485285","118818","59409.0"
"2","Substr.java","118214","366469","484683","118214","59107.0"
"2","ToBin.java","0","0","0","0","0"
"2","ToCharLong.java","0","0","0","0","0"
"2","ToHex.java","0","0","0","0","0"
"2","Upper.java","101185","370152","471337","101185","50592.0"
"2","FirstValue.java","49946","118111","168057","49946","24973.0"
"2","FirstValueDate.java","0","0","0","0","0"
"2","FirstValueDouble.java","0","0","0","0","0"
"2","FirstValueFloat.java","0","0","0","0","0"
"2","FirstValueInt.java","0","0","0","0","0"
"2","FirstValueLong.java","0","0","0","0","0"
"2","FirstValueString.java","0","0","0","0","0"
"2","FirstValueTime.java","0","0","0","0","0"
"2","FirstValueTimestamp.java","0","0","0","0","0"
"2","Lag.java","34400","96788","131188","34400","17200.0"
"2","LagDate.java","0","0","0","0","0"
"2","LagDouble.java","0","0","0","0","0"
"2","LagFloat.java","0","0","0","0","0"
"2","LagInt.java","0","0","0","0","0"
"2","LagLong.java","0","0","0","0","0"
"2","LagString.java","0","0","0","0","0"
"2","LagTime.java","0","0","0","0","0"
"2","LagTimestamp.java","0","0","0","0","0"
"2","Rank.java","0","0","0","0","0"
"2","RowNumber.java","0","0","0","0","0"
"2","CoreGsonHelper.java","74191","277263","351454","74191","37095.0"
"2","Enforcer.java","90373","190353","280726","90373","45186.0"
"2","DistinctGroupbyBuilder.java","89","615","704","89","44.0"
"2","DataChannel.java","90841","275983","366824","90841","45420.0"
"2","ExecutionBlock.java","82129","204350","286479","82129","41064.0"
"2","ExecutionBlockCursor.java","82121","209497","291618","82121","41060.0"
"2","ExecutionQueue.java","0","0","0","0","0"
"2","GlobalPlanner.java","82117","188586","270703","82117","41058.0"
"2","MasterPlan.java","90189","199539","289728","90189","45094.0"
"2","ParallelExecutionQueue.java","127186","171988","299174","127186","63593.0"
"2","BaseGlobalPlanRewriteRuleProvider.java","47050","111962","159012","47050","23525.0"
"2","GlobalPlanRewriteEngine.java","110986","221786","332772","110986","55493.0"
"2","GlobalPlanRewriteRule.java","0","0","0","0","0"
"2","GlobalPlanRewriteRuleProvider.java","0","0","0","0","0"
"2","GlobalPlanTestRuleProvider.java","0","0","0","0","0"
"2","BroadcastJoinRule.java","116525","133066","249591","116525","58262.0"
"2","GlobalPlanEqualityTester.java","0","0","0","0","0"
"2","GlobalPlanRewriteUtil.java","0","0","0","0","0"
"2","KeyProjector.java","0","0","0","0","0"
"2","AggregationExec.java","134828","302594","437422","134828","67414.0"
"2","BasicPhysicalExecutorVisitor.java","92755","391124","483879","92755","46377.0"
"2","BinaryPhysicalExec.java","0","0","0","0","0"
"2","BSTIndexScanExec.java","83604","321848","405452","83604","41802.0"
"2","ColPartitionStoreExec.java","110071","165762","275833","110071","55035.0"
"2","CommonHashJoinExec.java","31147","77687","108834","31147","15573.0"
"2","CommonJoinExec.java","10213","23123","33336","10213","5106.0"
"2","ComparableVector.java","1299","6754","8053","1299","649.0"
"2","DistinctGroupbyFirstAggregationExec.java","72906","104182","177088","72906","36453.0"
"2","DistinctGroupbyHashAggregationExec.java","89","615","704","89","44.0"
"2","DistinctGroupbySecondAggregationExec.java","111591","213498","325089","111591","55795.0"
"2","DistinctGroupbySortAggregationExec.java","2015","12521","14536","2015","1007.0"
"2","DistinctGroupbyThirdAggregationExec.java","84390","120082","204472","84390","42195.0"
"2","EmptyScanIterator.java","0","0","0","0","0"
"2","EvalExprExec.java","82133","191901","274034","82133","41066.0"
"2","ExternalSortExec.java","109714","147515","257229","109714","54857.0"
"2","FilterScanIterator.java","0","0","0","0","0"
"2","FullScanIterator.java","0","0","0","0","0"
"2","HashAggregateExec.java","82129","204063","286192","82129","41064.0"
"2","HashBasedColPartitionStoreExec.java","137127","363311","500438","137127","68563.0"
"2","HashFullOuterJoinExec.java","96050","268044","364094","96050","48025.0"
"2","HashJoinExec.java","83580","334734","418314","83580","41790.0"
"2","HashLeftAntiJoinExec.java","79733","332674","412407","79733","39866.0"
"2","HashLeftOuterJoinExec.java","96620","313018","409638","96620","48310.0"
"2","HashLeftSemiJoinExec.java","78666","269231","347897","78666","39333.0"
"2","HashPartitioner.java","0","0","0","0","0"
"2","HashShuffleFileWriteExec.java","82349","222925","305274","82349","41174.0"
"2","HavingExec.java","132757","303075","435832","132757","66378.0"
"2","IndexExecutorUtil.java","0","0","0","0","0"
"2","InsertRowsExec.java","0","0","0","0","0"
"2","JoinTupleComparator.java","0","0","0","0","0"
"2","KeyTuple.java","2685","2841","5526","2685","1342.0"
"2","LimitExec.java","0","0","0","0","0"
"2","MergeFullOuterJoinExec.java","97511","318650","416161","97511","48755.0"
"2","MergeJoinExec.java","83604","321848","405452","83604","41802.0"
"2","Partitioner.java","0","0","0","0","0"
"2","PartitionMergeScanExec.java","110520","158631","269151","110520","55260.0"
"2","PhysicalExec.java","82390","271489","353879","82390","41195.0"
"2","PhysicalExecutorVisitor.java","0","0","0","0","0"
"2","PhysicalPlanUtil.java","90598","220403","311001","90598","45299.0"
"2","ProjectionExec.java","0","0","0","0","0"
"2","RadixSort.java","0","0","0","0","0"
"2","RangeShuffleFileWriteExec.java","82577","284823","367400","82577","41288.0"
"2","RightOuterMergeJoinExec.java","95554","202259","297813","95554","47777.0"
"2","ScanExec.java","0","0","0","0","0"
"2","ScanIterator.java","0","0","0","0","0"
"2","SelectionExec.java","82390","271489","353879","82390","41195.0"
"2","SeqScanExec.java","82390","271489","353879","82390","41195.0"
"2","SetTupleComparator.java","0","0","0","0","0"
"2","SortAggregateExec.java","82133","193561","275694","82133","41066.0"
"2","SortBasedColPartitionStoreExec.java","110754","180202","290956","110754","55377.0"
"2","SortExec.java","83603","320421","404024","83603","41801.0"
"2","SortIntersectExec.java","0","0","0","0","0"
"2","StoreIndexExec.java","99780","108724","208504","99780","49890.0"
"2","StoreTableExec.java","82133","191901","274034","82133","41066.0"
"2","TunnelExec.java","0","0","0","0","0"
"2","TupleList.java","0","0","0","0","0"
"2","TupleMap.java","0","0","0","0","0"
"2","TupleSet.java","0","0","0","0","0"
"2","TupleSorter.java","2320","3992","6312","2320","1160.0"
"2","UnaryPhysicalExec.java","82390","271489","353879","82390","41195.0"
"2","UnionExec.java","0","0","0","0","0"
"2","VectorizedSorter.java","2320","3992","6312","2320","1160.0"
"2","WindowAggExec.java","35808","106404","142212","35808","17904.0"
"2","PhysicalPlanner.java","0","0","0","0","0"
"2","PhysicalPlannerImpl.java","82133","193561","275694","82133","41066.0"
"2","PhysicalPlanningException.java","0","0","0","0","0"
"2","Projector.java","82390","271489","353879","82390","41195.0"
"2","RangePartitionAlgorithm.java","82324","215856","298180","82324","41162.0"
"2","UniformRangePartition.java","82324","215856","298180","82324","41162.0"
"2","QueryContext.java","80092","185951","266043","80092","40046.0"
"2","TaskRequest.java","0","0","0","0","0"
"2","TaskRequestImpl.java","82390","271489","353879","90036","45018.0"
"2","CacheHolder.java","15320","32971","48291","15320","7660.0"
"2","TableCache.java","0","0","0","0","0"
"2","TableCacheKey.java","148834","282336","431170","148834","74417.0"
"2","ErrorInjectionRewriter.java","0","0","0","0","0"
"2","TupleUtil.java","82121","210472","292593","82121","41060.0"
"2","HdfsServiceTracker.java","5381","8241","13622","5381","2690.0"
"2","AsyncTaskService.java","0","0","0","0","0"
"2","WorkerConnectionInfo.java","0","0","0","0","0"
"2","FragmentScheduleEvent.java","125821","287403","413224","125821","62910.0"
"2","LocalTaskEvent.java","140321","359411","499732","140321","70160.0"
"2","LocalTaskEventType.java","0","0","0","0","0"
"2","QueryCompletedEvent.java","0","0","0","0","0"
"2","QueryDiagnosticsUpdateEvent.java","0","0","0","0","0"
"2","QueryEvent.java","0","0","0","0","0"
"2","QueryEventType.java","0","0","0","0","0"
"2","QueryMasterQueryCompletedEvent.java","0","0","0","0","0"
"2","QueryStartEvent.java","147482","353416","500898","147482","73741.0"
"2","QueryStopEvent.java","108386","212992","321378","108386","54193.0"
"2","StageCompletedEvent.java","82703","307090","389793","82703","41351.0"
"2","StageDiagnosticsUpdateEvent.java","120736","295584","416320","120736","60368.0"
"2","StageEvent.java","82703","307090","389793","82703","41351.0"
"2","StageEventType.java","82704","312487","395191","82704","41352.0"
"2","StageShuffleReportEvent.java","0","0","0","0","0"
"2","StageTaskEvent.java","0","0","0","0","0"
"2","StageTaskFailedEvent.java","0","0","0","0","0"
"2","TaskAttemptAssignedEvent.java","82390","272971","355361","82390","41195.0"
"2","TaskAttemptEvent.java","0","0","0","0","0"
"2","TaskAttemptEventType.java","0","0","0","0","0"
"2","TaskAttemptScheduleEvent.java","0","0","0","0","0"
"2","TaskAttemptStatusUpdateEvent.java","0","0","0","0","0"
"2","TaskAttemptToSchedulerEvent.java","0","0","0","0","0"
"2","TaskCompletionEvent.java","0","0","0","0","0"
"2","TaskEvent.java","0","0","0","0","0"
"2","TaskEventType.java","0","0","0","0","0"
"2","TaskFatalErrorEvent.java","0","0","0","0","0"
"2","TaskRequestEvent.java","0","0","0","0","0"
"2","TaskSchedulerEvent.java","0","0","0","0","0"
"2","TaskTAttemptEvent.java","82703","306590","389293","82703","41351.0"
"2","TaskTAttemptFailedEvent.java","0","0","0","0","0"
"2","CreateTableExecutor.java","3861","7590","11451","3861","1930.0"
"2","DDLExecutor.java","31951","46704","78655","31951","15975.0"
"2","ExplainGlobalPlanPreprocessorForTest.java","0","0","0","0","0"
"2","ExplainPlanPreprocessorForTest.java","20936","71145","92081","20936","10468.0"
"2","NonForwardQueryResultFileScanner.java","29489","43630","73119","29489","14744.0"
"2","NonForwardQueryResultScanner.java","73047","111147","184194","73047","36523.0"
"2","NonForwardQueryResultSystemScanner.java","21579","23334","44913","21579","10789.0"
"2","CreateTableHook.java","54138","126057","180195","54138","27069.0"
"2","DistributedQueryHook.java","0","0","0","0","0"
"2","DistributedQueryHookManager.java","0","0","0","0","0"
"2","InsertIntoHook.java","0","0","0","0","0"
"2","QueryExecutor.java","5093","10576","15669","5093","2546.0"
"2","GlobalEngine.java","82122","189959","272081","82122","41061.0"
"2","QueryCoordinatorService.java","79969","310379","390348","79969","39984.0"
"2","QueryInfo.java","79275","189490","268765","79275","39637.0"
"2","QueryInProgress.java","79275","189490","268765","79275","39637.0"
"2","QueryManager.java","79275","189490","268765","79275","39637.0"
"2","NodeEvent.java","142109","358708","500817","142109","71054.0"
"2","NodeEventType.java","0","0","0","0","0"
"2","NodeLivelinessMonitor.java","142109","358708","500817","142109","71054.0"
"2","NodeReconnectEvent.java","142109","358708","500817","142109","71054.0"
"2","NodeState.java","142109","358708","500817","142109","71054.0"
"2","NodeStatus.java","0","0","0","0","0"
"2","NodeStatusEvent.java","0","0","0","0","0"
"2","TajoResourceManager.java","0","0","0","0","0"
"2","TajoResourceTracker.java","140329","306888","447217","140329","70164.0"
"2","TajoRMContext.java","114181","226435","340616","114181","57090.0"
"2","WorkerResource.java","80949","373896","454845","80949","40474.0"
"2","FileSystemRule.java","0","0","0","0","0"
"2","MasterRuleProvider.java","0","0","0","0","0"
"2","AbstractQueryScheduler.java","0","0","0","0","0"
"2","ResourceReserveSchedulerEvent.java","0","0","0","0","0"
"2","SchedulerEvent.java","0","0","0","0","0"
"2","SchedulerEventType.java","0","0","0","0","0"
"2","QuerySchedulingInfo.java","99110","282161","381271","99110","49555.0"
"2","QueueInfo.java","0","0","0","0","0"
"2","QueueState.java","0","0","0","0","0"
"2","Scheduler.java","0","0","0","0","0"
"2","SchedulingAlgorithms.java","99110","282161","381271","99110","49555.0"
"2","SimpleScheduler.java","0","0","0","0","0"
"2","TajoResourceScheduler.java","0","0","0","0","0"
"2","TajoMaster.java","82348","220509","302857","82348","41174.0"
"2","TajoMasterClientService.java","82117","188494","270611","82117","41058.0"
"2","TaskState.java","0","0","0","0","0"
"2","ClusterResourceMetricSet.java","0","0","0","0","0"
"2","SQLAnalyzer.java","75250","200359","275609","128046","64023.0"
"2","SQLErrorListener.java","76524","396039","472563","76524","38262.0"
"2","SQLParseError.java","76524","396039","472563","76524","38262.0"
"2","AbstractTaskScheduler.java","83572","378498","462070","83572","41786.0"
"2","DefaultTaskScheduler.java","82121","209209","291330","82121","41060.0"
"2","FetchScheduleEvent.java","0","0","0","0","0"
"2","Query.java","82133","191901","274034","82133","41066.0"
"2","QueryJobEvent.java","0","0","0","0","0"
"2","QueryMaster.java","75925","217037","292962","75925","37962.0"
"2","QueryMasterManagerService.java","112190","214884","327074","112190","56095.0"
"2","QueryMasterTask.java","79275","189490","268765","125458","62729.0"
"2","Repartitioner.java","82129","204063","286192","123048","61524.0"
"2","Stage.java","3696","8935","12631","3696","1848.0"
"2","StageState.java","0","0","0","0","0"
"2","Task.java","82134","194345","276479","128077","64038.0"
"2","TaskAttempt.java","82134","194345","276479","121019","60509.0"
"2","TaskSchedulerContext.java","0","0","0","0","0"
"2","TaskSchedulerFactory.java","0","0","0","0","0"
"2","DefaultResourceCalculator.java","0","0","0","0","0"
"2","NodeResource.java","0","0","0","0","0"
"2","NodeResources.java","0","0","0","0","0"
"2","ResourceCalculator.java","0","0","0","0","0"
"2","NoSuchSessionVariableException.java","83983","380705","464688","83983","41991.0"
"2","Session.java","114338","131723","246061","114338","57169.0"
"2","SessionConstants.java","0","0","0","0","0"
"2","SessionEvent.java","0","0","0","0","0"
"2","SessionEventType.java","0","0","0","0","0"
"2","SessionLivelinessMonitor.java","0","0","0","0","0"
"2","SessionManager.java","116582","219214","335796","116582","58291.0"
"2","ApplicationIdUtils.java","0","0","0","0","0"
"2","GeoIPUtil.java","0","0","0","0","0"
"2","History.java","0","0","0","0","0"
"2","HistoryCleaner.java","0","0","0","0","0"
"2","HistoryReader.java","36471","53136","89607","36471","18235.0"
"2","HistoryWriter.java","39364","56529","95893","39364","19682.0"
"2","QueryHistory.java","39364","56529","95893","39364","19682.0"
"2","StageHistory.java","36471","53136","89607","36471","18235.0"
"2","TaskHistory.java","113779","154218","267997","113779","56889.0"
"2","IPconvertUtil.java","0","0","0","0","0"
"2","JSPUtil.java","90986","198836","289822","90986","45493.0"
"2","JvmPauseMonitor.java","0","0","0","0","0"
"2","GroupNameMetricsFilter.java","0","0","0","0","0"
"2","LogEventGaugeSet.java","0","0","0","0","0"
"2","MetricsFilterList.java","0","0","0","0","0"
"2","RegexpMetricsFilter.java","0","0","0","0","0"
"2","GangliaReporter.java","0","0","0","0","0"
"2","MetricsConsoleReporter.java","0","0","0","0","0"
"2","MetricsConsoleScheduledReporter.java","0","0","0","0","0"
"2","MetricsFileScheduledReporter.java","0","0","0","0","0"
"2","MetricsStreamScheduledReporter.java","0","0","0","0","0"
"2","NullReporter.java","0","0","0","0","0"
"2","TajoMetricsReporter.java","129232","370379","499611","129232","64616.0"
"2","TajoMetricsScheduledReporter.java","0","0","0","0","0"
"2","TajoJMXObjectNameFactory.java","0","0","0","0","0"
"2","TajoLogEventCounter.java","0","0","0","0","0"
"2","TajoMetrics.java","129236","370559","499795","129236","64618.0"
"2","TajoSystemMetrics.java","129236","370559","499795","129236","64618.0"
"2","RpcParameterFactory.java","0","0","0","0","0"
"2","SplitUtil.java","0","0","0","0","0"
"2","TajoUncaughtExceptionHandler.java","0","0","0","0","0"
"2","TimeZoneUtil.java","0","0","0","0","0"
"2","HttpServer.java","84547","417220","501767","84547","42273.0"
"2","QueryExecutorServlet.java","112060","187444","299504","112060","56030.0"
"2","StaticHttpServer.java","82697","314176","396873","82697","41348.0"
"2","AbstractFetcher.java","0","0","0","0","0"
"2","DeletionService.java","0","0","0","0","0"
"2","ExecutionBlockErrorEvent.java","108386","212992","321378","108386","54193.0"
"2","ExecutionBlockStopEvent.java","7998","13700","21698","7998","3999.0"
"2","NodeResourceAllocateEvent.java","24071","29501","53572","24071","12035.0"
"2","NodeResourceDeallocateEvent.java","24071","29501","53572","24071","12035.0"
"2","NodeResourceEvent.java","18376","18104","36480","18376","9188.0"
"2","NodeStatusEvent.java","0","0","0","0","0"
"2","QMResourceAllocateEvent.java","0","0","0","0","0"
"2","QueryStopEvent.java","108386","212992","321378","108386","54193.0"
"2","TaskManagerEvent.java","0","0","0","0","0"
"2","TaskStartEvent.java","18376","18104","36480","18376","9188.0"
"2","ExecutionBlockContext.java","69324","102891","172215","69324","34662.0"
"2","ExecutionBlockSharedResource.java","855","2076","2931","855","427.0"
"2","FetchImpl.java","10402","37478","47880","10402","5201.0"
"2","LocalFetcher.java","0","0","0","0","0"
"2","NodeResourceManager.java","7998","13700","21698","7998","3999.0"
"2","NodeStatusUpdater.java","7998","13700","21698","7998","3999.0"
"2","RemoteFetcher.java","82129","202244","284373","82129","41064.0"
"2","ConnectivityCheckerRuleForTajoWorker.java","12","123","135","12","6.0"
"2","WorkerRuleProvider.java","0","0","0","0","0"
"2","TajoQueryEngine.java","0","0","0","0","0"
"2","TajoWorker.java","79513","220784","300297","79513","39756.0"
"2","TajoWorkerClientService.java","75973","271417","347390","75973","37986.0"
"2","TajoWorkerManagerService.java","79282","200092","279374","79282","39641.0"
"2","Task.java","82134","194345","276479","128077","64038.0"
"2","TaskAttemptContext.java","82133","191901","274034","82133","41066.0"
"2","TaskContainer.java","0","0","0","0","0"
"2","TaskExecutor.java","18376","18104","36480","18376","9188.0"
"2","TaskHistory.java","113779","154218","267997","113779","56889.0"
"2","TaskImpl.java","18376","18104","36480","18376","9188.0"
"2","TaskManager.java","18376","18104","36480","18376","9188.0"
"2","RestReturnType.java","0","0","0","0","0"
"2","ClientApplication.java","10959","18318","29277","10959","5479.0"
"2","JerseyResourceDelegate.java","0","0","0","0","0"
"2","JerseyResourceDelegateContext.java","0","0","0","0","0"
"2","JerseyResourceDelegateContextKey.java","0","0","0","0","0"
"2","JerseyResourceDelegateUtil.java","0","0","0","0","0"
"2","NewDatabaseRequest.java","0","0","0","0","0"
"2","NewSessionRequest.java","0","0","0","0","0"
"2","SubmitQueryRequest.java","0","0","0","0","0"
"2","ClusterResource.java","35483","86544","122027","35483","17741.0"
"2","DatabasesResource.java","5770","11966","17736","5770","2885.0"
"2","FunctionsResource.java","24865","76158","101023","24865","12432.0"
"2","AbstractStreamingOutput.java","0","0","0","0","0"
"2","BinaryStreamingOutput.java","0","0","0","0","0"
"2","CSVStreamingOutput.java","0","0","0","0","0"
"2","RestOutputFactory.java","0","0","0","0","0"
"2","QueryResource.java","21796","69980","91776","21796","10898.0"
"2","QueryResultResource.java","27107","79829","106936","27107","13553.0"
"2","SessionsResource.java","0","0","0","0","0"
"2","TablesResource.java","27128","79851","106979","27128","13564.0"
"2","ResourcesUtil.java","0","0","0","0","0"
"2","DatabaseInfoResponse.java","0","0","0","0","0"
"2","ExceptionResponse.java","0","0","0","0","0"
"2","GetQueryResultDataResponse.java","0","0","0","0","0"
"2","GetSubmitQueryResponse.java","0","0","0","0","0"
"2","NewSessionResponse.java","0","0","0","0","0"
"2","ResultSetInfoResponse.java","0","0","0","0","0"
"2","WorkerConnectionInfoResponse.java","0","0","0","0","0"
"2","WorkerResponse.java","5770","11966","17736","5770","2885.0"
"2","TajoRestService.java","0","0","0","0","0"
"2","TestTPCH.java","83580","375555","459135","83580","41790.0"
"2","TestDDLBuilder.java","101626","409356","510982","101626","50813.0"
"2","TestTajoDump.java","151659","282708","434367","151659","75829.0"
"2","TestExecExternalShellCommand.java","0","0","0","0","0"
"2","TestHdfsCommand.java","0","0","0","0","0"
"2","TestDefaultCliOutputFormatter.java","11402","43570","54972","11402","5701.0"
"2","TestSimpleParser.java","114424","133167","247591","114424","57212.0"
"2","TestTajoCli.java","1519","4643","6162","1519","759.0"
"2","TestTajoCliNegatives.java","109654","140944","250598","109654","54827.0"
"2","TestCatalogAdminClientExceptions.java","0","0","0","0","0"
"2","TestQueryClientExceptions.java","106912","116183","223095","106912","53456.0"
"2","TestTajoClient.java","127869","177709","305578","127869","63934.0"
"2","TestTajoClientV2.java","3446","5585","9031","3446","1723.0"
"2","TestWorkerConnectionInfo.java","0","0","0","0","0"
"2","TestEvalCodeGenerator.java","0","0","0","0","0"
"2","TestGeneratorAdapter.java","0","0","0","0","0"
"2","ExprTestBase.java","90902","197157","288059","90902","45451.0"
"2","TestEvalTree.java","82349","221551","303900","126403","63201.0"
"2","TestEvalTreeUtil.java","82338","217588","299926","82338","41169.0"
"2","TestIntervalType.java","2925","16860","19785","2925","1462.0"
"2","TestPredicates.java","113448","264840","378288","113448","56724.0"
"2","TestSQLDateTimeTypes.java","82134","200335","282469","82134","41067.0"
"2","TestSQLExpression.java","1884","13772","15656","125529","62764.0"
"2","HiveUDFtest.java","0","0","0","0","0"
"2","TestHiveFunctionLoader.java","0","0","0","0","0"
"2","TestHiveFunctions.java","0","0","0","0","0"
"2","NullTestFunction.java","0","0","0","0","0"
"2","TestAggFunction.java","0","0","0","0","0"
"2","TestBuiltinFunctions.java","82704","312460","395164","82704","41352.0"
"2","TestConditionalExpressions.java","119141","139210","258351","119141","59570.0"
"2","TestDateTimeFunctions.java","114872","143934","258806","128069","64034.0"
"2","TestFunctionLoader.java","150215","295778","445993","150215","75107.0"
"2","TestGeneralFunction.java","0","0","0","0","0"
"2","TestJsonFunctions.java","46246","106952","153198","46246","23123.0"
"2","TestMathFunctions.java","114598","178049","292647","125376","62688.0"
"2","TestPatternMatchingPredicates.java","0","0","0","0","0"
"2","TestPythonFunctions.java","1668","4550","6218","1668","834.0"
"2","TestStringOperatorsAndFunctions.java","90678","209495","300173","90678","45339.0"
"2","TestUserDefinedFunctions.java","0","0","0","0","0"
"2","TestMasterPlan.java","0","0","0","0","0"
"2","TestExternalSortExec.java","82600","306204","388804","82600","41300.0"
"2","TestFullOuterHashJoinExec.java","95984","214129","310113","95984","47992.0"
"2","TestFullOuterMergeJoinExec.java","95984","214129","310113","95984","47992.0"
"2","TestHashAntiJoinExec.java","78283","215320","293603","78283","39141.0"
"2","TestHashJoinExec.java","82338","217588","299926","82338","41169.0"
"2","TestHashPartitioner.java","82254","214654","296908","82254","41127.0"
"2","TestHashSemiJoinExec.java","78604","215320","293924","78604","39302.0"
"2","TestLeftOuterHashJoinExec.java","95984","214129","310113","95984","47992.0"
"2","TestMergeJoinExec.java","82338","217588","299926","82338","41169.0"
"2","TestPhysicalPlanner.java","82134","201727","283861","82134","41067.0"
"2","TestProgressExternalSortExec.java","147396","354519","501915","147396","73698.0"
"2","TestRadixSort.java","0","0","0","0","0"
"2","TestRightOuterHashJoinExec.java","95984","214129","310113","95984","47992.0"
"2","TestRightOuterMergeJoinExec.java","95984","214129","310113","95984","47992.0"
"2","TestSortExec.java","82600","306204","388804","82600","41300.0"
"2","TestSortIntersectExec.java","112995","131080","244075","112995","56497.0"
"2","TestTupleSorter.java","41314","102190","143504","41314","20657.0"
"2","TestUnSafeTuple.java","0","0","0","0","0"
"2","TestEvalNodeToExprConverter.java","0","0","0","0","0"
"2","TestJoinOrderAlgorithm.java","0","0","0","0","0"
"2","TestLogicalOptimizer.java","82338","217588","299926","82338","41169.0"
"2","TestLogicalPlan.java","93091","414659","507750","93091","46545.0"
"2","TestLogicalPlanner.java","82117","188494","270611","82117","41058.0"
"2","TestPlannerUtil.java","82389","274013","356402","82389","41194.0"
"2","TestQueryValidation.java","71557","99893","171450","71557","35778.0"
"2","TestUniformRangePartition.java","82324","215856","298180","82324","41162.0"
"2","TestAlterTable.java","148486","293626","442112","148486","74243.0"
"2","TestAlterTablespace.java","0","0","0","0","0"
"2","TestCaseByCases.java","0","0","0","0","0"
"2","TestCommonConditionReduce.java","0","0","0","0","0"
"2","TestCreateDatabase.java","0","0","0","0","0"
"2","TestCreateIndex.java","0","0","0","0","0"
"2","TestCreateTable.java","114808","144976","259784","114808","57404.0"
"2","TestCrossJoin.java","0","0","0","0","0"
"2","TestCTASQuery.java","127687","296394","424081","127687","63843.0"
"2","TestDropTable.java","0","0","0","0","0"
"2","TestGroupByQuery.java","82133","193561","275694","82133","41066.0"
"2","TestHBaseTable.java","21013","25417","46430","21013","10506.0"
"2","TestIndexScan.java","0","0","0","0","0"
"2","TestInnerJoinQuery.java","0","0","0","0","0"
"2","TestInnerJoinWithSubQuery.java","124473","150320","274793","124473","62236.0"
"2","TestInsertQuery.java","80295","189459","269754","127296","63648.0"
"2","TestInSubquery.java","0","0","0","0","0"
"2","TestJoinOnPartitionedTables.java","110521","160221","270742","110521","55260.0"
"2","TestJoinQuery.java","123804","185300","309104","123804","61902.0"
"2","TestJsonWithTimezone.java","0","0","0","0","0"
"2","TestMultipleJoinTypes.java","29163","38196","67359","29163","14581.0"
"2","TestNullValues.java","82134","201727","283861","82134","41067.0"
"2","TestOuterJoinQuery.java","8068","12633","20701","8068","4034.0"
"2","TestOuterJoinWithSubQuery.java","0","0","0","0","0"
"2","TestQueryOnSelfDescTable.java","1515","5833","7348","1515","757.0"
"2","TestSelectNestedRecord.java","39148","90524","129672","39148","19574.0"
"2","TestSelectQuery.java","82129","206087","288216","125246","62623.0"
"2","TestSetSessionQuery.java","130433","261567","392000","130433","65216.0"
"2","TestSimpleQuery.java","0","0","0","0","0"
"2","TestSortQuery.java","82133","191653","273786","82133","41066.0"
"2","TestTablePartitions.java","126050","190939","316989","126050","63025.0"
"2","TestTableSubQuery.java","0","0","0","0","0"
"2","TestTimezone.java","0","0","0","0","0"
"2","TestTruncateTable.java","72329","177897","250226","72329","36164.0"
"2","TestUnionQuery.java","127003","177978","304981","127003","63501.0"
"2","TestWindowQuery.java","3329","13805","17134","3329","1664.0"
"2","BenchmarkSort.java","0","0","0","0","0"
"2","TestTableCache.java","0","0","0","0","0"
"2","TestTupleUtil.java","83580","335453","419033","83580","41790.0"
"2","TestHAServiceHDFSImpl.java","42223","113600","155823","42223","21111.0"
"2","TestMasterRules.java","0","0","0","0","0"
"2","TestSimpleScheduler.java","0","0","0","0","0"
"2","TestExecutionBlockCursor.java","112715","202289","315004","112715","56357.0"
"2","TestNonForwardQueryResultSystemScanner.java","22815","25117","47932","22815","11407.0"
"2","TestQueryResult.java","0","0","0","0","0"
"2","TestRepartitioner.java","82324","215608","297932","82324","41162.0"
"2","TestSQLAnalyzer.java","77440","393686","471126","77440","38720.0"
"2","TestIntermediateEntry.java","0","0","0","0","0"
"2","TestKillQuery.java","72356","106622","178978","72356","36178.0"
"2","TestQueryProgress.java","84042","122362","206404","84042","42021.0"
"2","TestQueryState.java","31801","77988","109789","31801","15900.0"
"2","TestTaskStatusUpdate.java","114109","161521","275630","114109","57054.0"
"2","TestResources.java","0","0","0","0","0"
"2","TestFileFragment.java","0","0","0","0","0"
"2","TestQueryOnOrcFile.java","0","0","0","0","0"
"2","TestQueryIdFactory.java","82703","306590","389293","82703","41351.0"
"2","TestTajoIds.java","82703","306590","389293","82703","41351.0"
"2","TestHistoryWriterReader.java","36471","53136","89607","36471","18235.0"
"2","TestJMXTajoObjectNameFactory.java","0","0","0","0","0"
"2","TestMetricsFilter.java","0","0","0","0","0"
"2","TestSystemMetrics.java","129236","370559","499795","129236","64618.0"
"2","TestIPconvertUtil.java","0","0","0","0","0"
"2","TestJSPUtil.java","123948","251494","375442","123948","61974.0"
"2","TestRpcParamFactory.java","0","0","0","0","0"
"2","TestTimeZoneUtil.java","0","0","0","0","0"
"2","MockExecutionBlockContext.java","0","0","0","0","0"
"2","MockNodeResourceManager.java","18376","18104","36480","18376","9188.0"
"2","MockNodeStatusUpdater.java","24071","29501","53572","24071","12035.0"
"2","MockTaskExecutor.java","18376","18104","36480","18376","9188.0"
"2","MockTaskManager.java","18376","18104","36480","18376","9188.0"
"2","MockWorkerContext.java","0","0","0","0","0"
"2","TestDeletionService.java","0","0","0","0","0"
"2","TestFetcherWithTajoPullServer.java","0","0","0","0","0"
"2","TestNodeResourceManager.java","7998","13700","21698","7998","3999.0"
"2","TestNodeStatusUpdater.java","7998","13700","21698","7998","3999.0"
"2","TestTaskExecutor.java","18376","18104","36480","18376","9188.0"
"2","TestTaskManager.java","18376","18104","36480","18376","9188.0"
"2","TestClusterResource.java","0","0","0","0","0"
"2","TestDatabasesResource.java","0","0","0","0","0"
"2","TestFunctionsResource.java","24865","76158","101023","24865","12432.0"
"2","TestQueryResource.java","21796","69980","91776","21796","10898.0"
"2","TestQueryResultResource.java","21796","69980","91776","21796","10898.0"
"2","TestSessionsResource.java","0","0","0","0","0"
"2","TestTablesResource.java","27128","79851","106979","27128","13564.0"
"2","JdbcConnection.java","124390","232474","356864","124390","62195.0"
"2","TajoDatabaseMetaData.java","113969","179575","293544","116150","58075.0"
"2","TajoDriver.java","0","0","0","0","0"
"2","TajoPreparedStatement.java","114590","262376","376966","114590","57295.0"
"2","TajoStatement.java","114590","262376","376966","114590","57295.0"
"2","QueryStringDecoder.java","0","0","0","0","0"
"2","TestResultSet.java","82129","203780","285909","82129","41064.0"
"2","TestSQLState.java","0","0","0","0","0"
"2","TestTajoDatabaseMetaData.java","121159","214756","335915","121159","60579.0"
"2","TestTajoJdbc.java","114590","262376","376966","116150","58075.0"
"2","TestTajoJdbcNegative.java","6339","9293","15632","6339","3169.0"
"2","TestQueryStringDecoder.java","0","0","0","0","0"
"2","TestResultSetUtil.java","0","0","0","0","0"
"2","ProtocMojo.java","0","0","0","0","0"
"2","Exec.java","0","0","0","0","0"
"2","FileSetUtils.java","0","0","0","0","0"
"2","VersionInfoMojo.java","0","0","0","0","0"
"2","MetricsUtil.java","0","0","0","0","0"
"2","TestMetricsUtil.java","0","0","0","0","0"
"2","AlgebraVisitor.java","77524","380379","457903","77524","38762.0"
"2","BaseAlgebraVisitor.java","75664","202689","278353","126247","63123.0"
"2","Prioritized.java","0","0","0","0","0"
"2","AggregationFunctionCallEval.java","82121","207772","289893","82121","41060.0"
"2","AlgebraicException.java","0","0","0","0","0"
"2","AlgebraicUtil.java","82121","207772","289893","125628","62814.0"
"2","BasicEvalNodeVisitor.java","90452","204692","295144","121162","60581.0"
"2","BetweenPredicateEval.java","111733","213810","325543","111733","55866.0"
"2","BinaryEval.java","82338","218465","300803","125529","62764.0"
"2","CaseWhenEval.java","82129","204873","287002","127789","63894.0"
"2","CastEval.java","91952","291849","383801","91952","45976.0"
"2","ConstEval.java","82349","221551","303900","82349","41174.0"
"2","EvalContext.java","1668","4550","6218","1668","834.0"
"2","EvalNode.java","82701","309764","392465","91016","45508.0"
"2","EvalNodeVisitor.java","0","0","0","0","0"
"2","EvalNodeVisitor2.java","0","0","0","0","0"
"2","EvalTreeFactory.java","0","0","0","0","0"
"2","EvalTreeUtil.java","82129","205098","287227","126403","63201.0"
"2","EvalType.java","75774","269771","345545","90682","45341.0"
"2","FieldEval.java","82349","221551","303900","82349","41174.0"
"2","FunctionEval.java","82338","218465","300803","82338","41169.0"
"2","GeneralFunctionEval.java","82592","295074","377666","82592","41296.0"
"2","InEval.java","80748","317805","398553","80748","40374.0"
"2","InvalidEvalException.java","0","0","0","0","0"
"2","IsNullEval.java","83594","319885","403479","83594","41797.0"
"2","LikePredicateEval.java","91366","268519","359885","91366","45683.0"
"2","NotEval.java","83604","321848","405452","83604","41802.0"
"2","PartialBinaryExpr.java","83604","321848","405452","83604","41802.0"
"2","PatternMatchPredicateEval.java","91366","268519","359885","91366","45683.0"
"2","RegexPredicateEval.java","92794","317139","409933","92794","46397.0"
"2","RowConstantEval.java","80738","333257","413995","80738","40369.0"
"2","SignedEval.java","123645","311898","435543","123645","61822.0"
"2","SimilarToPredicateEval.java","91366","268519","359885","91366","45683.0"
"2","SimpleEvalNodeVisitor.java","8079","27417","35496","8079","4039.0"
"2","SubqueryEval.java","0","0","0","0","0"
"2","UnaryEval.java","11011","43900","54911","11011","5505.0"
"2","ValueSetEval.java","0","0","0","0","0"
"2","WindowFunctionEval.java","35808","106404","142212","35808","17904.0"
"2","ExprAnnotator.java","127003","177278","304281","127266","63633.0"
"2","ExprNormalizer.java","127084","179218","306302","127084","63542.0"
"2","EvalTreeOptimizationRule.java","34320","94440","128760","34320","17160.0"
"2","EvalTreeOptimizer.java","3179","63032","66211","3179","1589.0"
"2","ConstantFolding.java","86258","188375","274633","86258","43129.0"
"2","ConstantPropagation.java","34320","94440","128760","34320","17160.0"
"2","AggFunction.java","83622","334927","418549","83622","41811.0"
"2","AggFunctionInvoke.java","0","0","0","0","0"
"2","ClassBasedAggFunctionInvoke.java","0","0","0","0","0"
"2","ClassBasedScalarFunctionInvoke.java","1668","4550","6218","1668","834.0"
"2","FunctionContext.java","0","0","0","0","0"
"2","FunctionInvoke.java","83256","142984","226240","83256","41628.0"
"2","FunctionInvokeContext.java","1668","4550","6218","1668","834.0"
"2","GeneralFunction.java","82592","295074","377666","82592","41296.0"
"2","HiveFunctionInvoke.java","0","0","0","0","0"
"2","PythonScriptEngine.java","1668","4550","6218","1668","834.0"
"2","TajoScriptEngine.java","1668","4550","6218","1668","834.0"
"2","PythonAggFunctionInvoke.java","0","0","0","0","0"
"2","PythonFunctionInvoke.java","0","0","0","0","0"
"2","BufferPool.java","66502","110968","177470","66502","33251.0"
"2","ByteBufInputChannel.java","0","0","0","0","0"
"2","ByteBufLineReader.java","4085","11290","15375","4085","2042.0"
"2","CSVLineDeserializer.java","57980","81059","139039","57980","28990.0"
"2","CSVLineSerDe.java","66186","103979","170165","66186","33093.0"
"2","CSVLineSerializer.java","57980","81059","139039","57980","28990.0"
"2","FieldSerializerDeserializer.java","66502","110968","177470","66502","33251.0"
"2","FieldSplitProcessor.java","0","0","0","0","0"
"2","InputHandler.java","0","0","0","0","0"
"2","LineSplitProcessor.java","0","0","0","0","0"
"2","OutputHandler.java","1668","4550","6218","1668","834.0"
"2","StreamingUtil.java","1668","4550","6218","1668","834.0"
"2","TextFieldSerializerDeserializer.java","1479","7317","8796","1479","739.0"
"2","TextLineDeserializer.java","66186","103979","170165","66186","33093.0"
"2","TextLineParsingError.java","0","0","0","0","0"
"2","TextLineSerDe.java","66186","103979","170165","66186","33093.0"
"2","TextLineSerializer.java","1668","4550","6218","1668","834.0"
"2","WindowAggFunc.java","0","0","0","0","0"
"2","Edge.java","0","0","0","0","0"
"2","FoundJoinOrder.java","0","0","0","0","0"
"2","GreedyHeuristicJoinOrderAlgorithm.java","112844","199027","311871","112844","56422.0"
"2","JoinEdge.java","100877","377154","478031","100877","50438.0"
"2","JoinedRelationsVertex.java","0","0","0","0","0"
"2","JoinGraph.java","98907","199629","298536","98907","49453.0"
"2","JoinGraphContext.java","18640","16847","35487","18640","9320.0"
"2","JoinOrderAlgorithm.java","113608","272228","385836","113608","56804.0"
"2","JoinOrderingUtil.java","22597","29806","52403","22597","11298.0"
"2","JoinVertex.java","0","0","0","0","0"
"2","RelationVertex.java","0","0","0","0","0"
"2","AlterTableNode.java","144736","277945","422681","144736","72368.0"
"2","AlterTablespaceNode.java","149801","276116","425917","149801","74900.0"
"2","BinaryNode.java","0","0","0","0","0"
"2","CreateDatabaseNode.java","141361","279432","420793","141361","70680.0"
"2","CreateIndexNode.java","0","0","0","0","0"
"2","CreateTableNode.java","82701","309764","392465","82701","41350.0"
"2","DistinctGroupbyNode.java","12726","97085","109811","12726","6363.0"
"2","DropDatabaseNode.java","141361","279432","420793","141361","70680.0"
"2","DropIndexNode.java","0","0","0","0","0"
"2","DropTableNode.java","75817","308829","384646","75817","37908.0"
"2","EvalExprNode.java","83594","319885","403479","83594","41797.0"
"2","ExceptNode.java","0","0","0","0","0"
"2","GroupbyNode.java","82133","193561","275694","82133","41066.0"
"2","GroupElement.java","0","0","0","0","0"
"2","HavingNode.java","127846","249019","376865","127846","63923.0"
"2","IndexScanNode.java","83594","319885","403479","83594","41797.0"
"2","InsertNode.java","80987","307446","388433","80987","40493.0"
"2","IntersectNode.java","0","0","0","0","0"
"2","JoinNode.java","83594","319885","403479","83594","41797.0"
"2","JoinSpec.java","0","0","0","0","0"
"2","LimitNode.java","82572","278819","361391","82572","41286.0"
"2","LogicalNode.java","82572","278819","361391","82572","41286.0"
"2","LogicalNodeVisitor.java","0","0","0","0","0"
"2","LogicalRootNode.java","0","0","0","0","0"
"2","NodeType.java","76092","308053","384145","76092","38046.0"
"2","PartitionedTableScanNode.java","126789","264764","391553","126789","63394.0"
"2","PersistentStoreNode.java","128902","303007","431909","128902","64451.0"
"2","Projectable.java","0","0","0","0","0"
"2","ProjectionNode.java","82701","309764","392465","82701","41350.0"
"2","RelationNode.java","92070","332718","424788","92070","46035.0"
"2","ScanNode.java","82390","271489","353879","82390","41195.0"
"2","SelectableNode.java","0","0","0","0","0"
"2","SelectionNode.java","82390","271489","353879","82390","41195.0"
"2","SetOperationNode.java","0","0","0","0","0"
"2","SetSessionNode.java","0","0","0","0","0"
"2","ShuffleFileWriteNode.java","128902","303007","431909","128902","64451.0"
"2","SortNode.java","83594","319885","403479","83594","41797.0"
"2","StoreTableNode.java","82572","278819","361391","82572","41286.0"
"2","TableSubQueryNode.java","93152","421129","514281","93152","46576.0"
"2","TruncateTableNode.java","72329","177897","250226","72329","36164.0"
"2","UnaryNode.java","0","0","0","0","0"
"2","UnionNode.java","0","0","0","0","0"
"2","WindowAggNode.java","134154","347585","481739","134154","67077.0"
"2","WindowSpec.java","69654","171066","240720","69654","34827.0"
"2","LogicalOptimizer.java","82129","205939","288068","82129","41064.0"
"2","LogicalPlan.java","75245","201728","276973","75245","37622.0"
"2","LogicalPlanner.java","82133","191901","274034","127789","63894.0"
"2","LogicalPlanPreprocessor.java","135500","380493","515993","135500","67750.0"
"2","NamedExprsManager.java","127770","195971","323741","127770","63885.0"
"2","NameResolver.java","89225","209410","298635","89225","44612.0"
"2","NameResolvingMode.java","0","0","0","0","0"
"2","ResolverByLegacy.java","35159","99838","134997","35159","17579.0"
"2","ResolverByRels.java","35159","99838","134997","35159","17579.0"
"2","ResolverByRelsAndSubExprs.java","35159","99838","134997","35159","17579.0"
"2","ResolverBySubExprsAndRels.java","35159","99838","134997","35159","17579.0"
"2","PlanString.java","93091","414659","507750","93091","46545.0"
"2","BaseLogicalPlanPreprocessEngine.java","0","0","0","0","0"
"2","BaseLogicalPlanPreprocessPhaseProvider.java","0","0","0","0","0"
"2","BaseLogicalPlanRewriteEngine.java","75417","189024","264441","75417","37708.0"
"2","BaseLogicalPlanRewriteRuleProvider.java","67172","146683","213855","67172","33586.0"
"2","BaseSchemaBuildPhase.java","2958","22080","25038","2958","1479.0"
"2","LogicalPlanPreprocessEngine.java","0","0","0","0","0"
"2","LogicalPlanPreprocessPhase.java","0","0","0","0","0"
"2","LogicalPlanPreprocessPhaseProvider.java","0","0","0","0","0"
"2","LogicalPlanRewriteEngine.java","75999","308832","384831","75999","37999.0"
"2","LogicalPlanRewriteRule.java","75872","277889","353761","75872","37936.0"
"2","LogicalPlanRewriteRuleContext.java","115965","156612","272577","115965","57982.0"
"2","LogicalPlanRewriteRuleProvider.java","0","0","0","0","0"
"2","LogicalPlanTestRuleProvider.java","0","0","0","0","0"
"2","AccessPathInfo.java","0","0","0","0","0"
"2","AccessPathRewriter.java","0","0","0","0","0"
"2","CommonConditionReduceRule.java","95581","98270","193851","95581","47790.0"
"2","FilterPushDownRule.java","74111","199460","273571","124318","62159.0"
"2","IndexScanInfo.java","0","0","0","0","0"
"2","InSubqueryRewriteRule.java","0","0","0","0","0"
"2","LogicalPlanEqualityTester.java","65395","138862","204257","65395","32697.0"
"2","PartitionedTableRewriter.java","127038","265313","392351","127038","63519.0"
"2","ProjectionPushDownRule.java","74110","190355","264465","74110","37055.0"
"2","SeqScanInfo.java","0","0","0","0","0"
"2","SelfDescSchemaBuildPhase.java","1515","5833","7348","1515","757.0"
"2","TableStatUpdateRewriter.java","5027","8110","13137","5027","2513.0"
"2","EvalNodeAdapter.java","82572","278819","361391","82572","41286.0"
"2","EvalNodeDeserializer.java","73002","160863","233865","73002","36501.0"
"2","EvalNodeSerializer.java","73002","160863","233865","73002","36501.0"
"2","LogicalNodeAdapter.java","82572","278819","361391","82572","41286.0"
"2","LogicalNodeDeserializer.java","23033","29473","52506","23033","11516.0"
"2","LogicalNodeSerializer.java","23033","29473","52506","23033","11516.0"
"2","package-info.java","0","0","0","0","0"
"2","PlanGsonHelper.java","0","0","0","0","0"
"2","StorageService.java","123914","158234","282148","123914","61957.0"
"2","TablePropertyUtil.java","127059","169535","296594","127059","63529.0"
"2","Target.java","75690","277886","353576","75690","37845.0"
"2","TypeDeterminant.java","6109","76438","82547","6109","3054.0"
"2","EvalNodeToExprConverter.java","5892","9575","15467","5892","2946.0"
"2","ExprFinder.java","134808","364207","499015","134808","67404.0"
"2","PartitionFilterAlgebraVisitor.java","0","0","0","0","0"
"2","PlannerUtil.java","82117","188586","270703","126403","63201.0"
"2","WritableTypeConverter.java","0","0","0","0","0"
"2","ExprsVerifier.java","115067","415470","530537","127633","63816.0"
"2","LogicalPlanVerifier.java","111391","270808","382199","111391","55695.0"
"2","PostLogicalPlanVerifier.java","0","0","0","0","0"
"2","PreLogicalPlanVerifier.java","127945","181007","308952","127945","63972.0"
"2","SyntaxErrorException.java","114440","374153","488593","114440","57220.0"
"2","SyntaxErrorUtil.java","113147","127045","240192","113147","56573.0"
"2","VerificationState.java","114348","374419","488767","114348","57174.0"
"2","BasicLogicalPlanVisitor.java","74110","191986","266096","74110","37055.0"
"2","ExplainLogicalPlanVisitor.java","90185","190508","280693","90185","45092.0"
"2","LogicalPlanVisitor.java","74110","191986","266096","74110","37055.0"
"2","SimpleAlgebraVisitor.java","127179","184904","312083","127179","63589.0"
"2","TestExprAnnotator.java","0","0","0","0","0"
"2","TestLogicalNode.java","82572","278819","361391","82572","41286.0"
"2","TestWritableTypeConverter.java","0","0","0","0","0"
"2","FadvisedChunkedFile.java","84814","126137","210951","84814","42407.0"
"2","FadvisedFileRegion.java","84814","126137","210951","84814","42407.0"
"2","FileAccessForbiddenException.java","0","0","0","0","0"
"2","FileCloseListener.java","144714","284640","429354","144714","72357.0"
"2","HttpDataServerChannelInitializer.java","82775","314577","397352","82775","41387.0"
"2","HttpDataServerHandler.java","82775","314577","397352","82775","41387.0"
"2","HttpUtil.java","0","0","0","0","0"
"2","PullServerConstants.java","0","0","0","0","0"
"2","PullServerUtil.java","0","0","0","0","0"
"2","AdvancedDataRetriever.java","82703","306590","389293","82703","41351.0"
"2","DataRetriever.java","0","0","0","0","0"
"2","DirectoryRetriever.java","0","0","0","0","0"
"2","FileChunk.java","0","0","0","0","0"
"2","FileChunkMeta.java","0","0","0","0","0"
"2","IndexCacheKey.java","0","0","0","0","0"
"2","RetrieverHandler.java","0","0","0","0","0"
"2","TajoPullServer.java","0","0","0","0","0"
"2","TajoPullServerService.java","79274","207845","287119","79274","39637.0"
"2","NettyServerBase.java","82775","314577","397352","82775","41387.0"
"2","NettyUtils.java","6187","30766","36953","6187","3093.0"
"2","RemoteException.java","0","0","0","0","0"
"2","RetriesExhaustedException.java","0","0","0","0","0"
"2","RpcConstants.java","0","0","0","0","0"
"2","RpcEventListener.java","0","0","0","0","0"
"2","RpcUtils.java","11197","14951","26148","11197","5598.0"
"2","AsyncRpcClient.java","82775","314577","397352","82775","41387.0"
"2","AsyncRpcServer.java","82775","314577","397352","82775","41387.0"
"2","BlockingRpcClient.java","82775","314577","397352","127157","63578.0"
"2","BlockingRpcServer.java","82775","314577","397352","82775","41387.0"
"2","CallFuture.java","82775","314577","397352","82775","41387.0"
"2","CancelableRpcCallback.java","0","0","0","0","0"
"2","ChannelEventListener.java","4696","9687","14383","4696","2348.0"
"2","DefaultRpcController.java","111725","305662","417387","111725","55862.0"
"2","MonitorClientHandler.java","0","0","0","0","0"
"2","MonitorServerHandler.java","0","0","0","0","0"
"2","MonitorStateEvent.java","0","0","0","0","0"
"2","NettyClientBase.java","82389","273152","355541","82389","41194.0"
"2","NettyRpcController.java","0","0","0","0","0"
"2","NullCallback.java","83604","328510","412114","83604","41802.0"
"2","ProtoClientChannelInitializer.java","12183","30442","42625","12183","6091.0"
"2","ProtoDeclaration.java","0","0","0","0","0"
"2","ProtoServerChannelInitializer.java","0","0","0","0","0"
"2","RecoverableException.java","4696","9687","14383","4696","2348.0"
"2","RemoteCallException.java","82389","274321","356710","82389","41194.0"
"2","RpcClientManager.java","4696","9687","14383","4696","2348.0"
"2","RpcConnectionKey.java","0","0","0","0","0"
"2","TajoServiceException.java","0","0","0","0","0"
"2","DummyProtocolAsyncImpl.java","83622","333683","417305","83622","41811.0"
"2","DummyProtocolBlockingImpl.java","83622","333683","417305","83622","41811.0"
"2","TestAsyncRpc.java","82121","209776","291897","82121","41060.0"
"2","TestBlockingRpc.java","82389","273152","355541","114578","57289.0"
"2","TestRpcClientManager.java","4696","9687","14383","4696","2348.0"
"2","GsonFeature.java","3540","11523","15063","3540","1770.0"
"2","GsonReader.java","0","0","0","0","0"
"2","GsonUtil.java","0","0","0","0","0"
"2","GsonWriter.java","0","0","0","0","0"
"2","NettyRestChannelInitializer.java","0","0","0","0","0"
"2","NettyRestHandlerContainer.java","0","0","0","0","0"
"2","NettyRestHandlerContainerProvider.java","0","0","0","0","0"
"2","NettyRestServer.java","0","0","0","0","0"
"2","NettyRestServerFactory.java","0","0","0","0","0"
"2","NettyRestServerListener.java","0","0","0","0","0"
"2","ResourceConfigUtil.java","0","0","0","0","0"
"2","NettyRestHandlerContainerProviderTest.java","0","0","0","0","0"
"2","NettyRestServerTest.java","0","0","0","0","0"
"2","TestApplication1.java","0","0","0","0","0"
"2","TestResource1.java","0","0","0","0","0"
"2","DirectoriesDao.java","0","0","0","0","0"
"2","DirectoriesResource.java","0","0","0","0","0"
"2","Directory.java","0","0","0","0","0"
"2","FileManagementApplication.java","0","0","0","0","0"
"2","AbstractScanner.java","84967","154628","239595","84967","42483.0"
"2","ForSplitableStore.java","0","0","0","0","0"
"2","Appender.java","82338","217588","299926","82338","41169.0"
"2","BaseTupleComparator.java","126971","262752","389723","126971","63485.0"
"2","BinarySerializerDeserializer.java","117863","327845","445708","117863","58931.0"
"2","ByteBufInputChannel.java","0","0","0","0","0"
"2","CodecPool.java","0","0","0","0","0"
"2","DataLocation.java","0","0","0","0","0"
"2","DiskDeviceInfo.java","0","0","0","0","0"
"2","DiskInfo.java","0","0","0","0","0"
"2","DiskMountInfo.java","0","0","0","0","0"
"2","DiskUtil.java","0","0","0","0","0"
"2","AlreadyExistsStorageException.java","0","0","0","0","0"
"2","UnknownCodecException.java","0","0","0","0","0"
"2","UnsupportedFileTypeException.java","0","0","0","0","0"
"2","FormatProperty.java","0","0","0","0","0"
"2","BuiltinFragmentKinds.java","0","0","0","0","0"
"2","Fragment.java","0","0","0","0","0"
"2","FragmentConvertor.java","0","0","0","0","0"
"2","FragmentSerde.java","0","0","0","0","0"
"2","FrameTuple.java","82390","271489","353879","82390","41195.0"
"2","FSDataInputChannel.java","85801","148391","234192","85801","42900.0"
"2","InputChannel.java","0","0","0","0","0"
"2","LazyTuple.java","110950","179189","290139","110950","55475.0"
"2","LocalFileInputChannel.java","41398","95910","137308","41398","20699.0"
"2","MergeScanner.java","82390","276431","358821","82390","41195.0"
"2","NullScanner.java","106029","190576","296605","106029","53014.0"
"2","NumericPathComparator.java","0","0","0","0","0"
"2","OldStorageManager.java","0","0","0","0","0"
"2","RowStoreUtil.java","82247","213856","296103","121041","60520.0"
"2","Scanner.java","82600","306204","388804","82600","41300.0"
"2","SeekableChannel.java","0","0","0","0","0"
"2","SeekableInputChannel.java","0","0","0","0","0"
"2","SeekableScanner.java","0","0","0","0","0"
"2","SerializerDeserializer.java","117849","368326","486175","117849","58924.0"
"2","StorageProperty.java","82600","306204","388804","82600","41300.0"
"2","StorageUtil.java","82121","212666","294787","82121","41060.0"
"2","Tablespace.java","51242","115196","166438","51242","25621.0"
"2","TablespaceManager.java","16903","61846","78749","16903","8451.0"
"2","TableStatistics.java","143733","404428","548161","143733","71866.0"
"2","TextSerializerDeserializer.java","113901","190211","304112","126415","63207.0"
"2","TupleComparator.java","0","0","0","0","0"
"2","TupleRange.java","82350","224216","306566","82350","41175.0"
"2","TestFrameTuple.java","0","0","0","0","0"
"2","TestLazyTuple.java","90388","373387","463775","90388","45194.0"
"2","TestTupleComparator.java","82577","284823","367400","82577","41288.0"
"2","TestVTuple.java","0","0","0","0","0"
"2","AbstractHBaseAppender.java","71495","152828","224323","71495","35747.0"
"2","ColumnMapping.java","28414","38089","66503","28414","14207.0"
"2","HBaseBinarySerializerDeserializer.java","39567","67716","107283","39567","19783.0"
"2","HBaseFragment.java","0","0","0","0","0"
"2","HBaseFragmentSerde.java","0","0","0","0","0"
"2","HBasePutAppender.java","56224","128780","185004","56224","28112.0"
"2","HBaseScanner.java","28414","38089","66503","28414","14207.0"
"2","HBaseStorageConstants.java","0","0","0","0","0"
"2","HBaseTablespace.java","28414","38089","66503","28414","14207.0"
"2","HBaseTextSerializerDeserializer.java","0","0","0","0","0"
"2","HFileAppender.java","0","0","0","0","0"
"2","IndexPredication.java","0","0","0","0","0"
"2","RegionSizeCalculator.java","0","0","0","0","0"
"2","RowKeyMapping.java","82600","306204","388804","82600","41300.0"
"2","SortedInsertRewriter.java","56224","128780","185004","56224","28112.0"
"2","TestColumnMapping.java","116215","231739","347954","116215","58107.0"
"2","TestHBaseTableSpace.java","56224","128780","185004","56224","28112.0"
"2","AvroAppender.java","150175","271881","422056","150175","75087.0"
"2","AvroScanner.java","157001","351755","508756","157001","78500.0"
"2","AvroUtil.java","132915","241018","373933","132915","66457.0"
"2","package-info.java","0","0","0","0","0"
"2","FieldSerializerDeserializer.java","66502","110968","177470","66502","33251.0"
"2","FileAppender.java","82350","223260","305610","82350","41175.0"
"2","FileScanner.java","84545","415025","499570","84545","42272.0"
"2","FileTablespace.java","18317","90287","108604","18317","9158.0"
"2","AbstractFileFragment.java","0","0","0","0","0"
"2","FileFragment.java","0","0","0","0","0"
"2","FileFragmentSerde.java","0","0","0","0","0"
"2","HashShuffleAppenderManager.java","144643","343056","487699","144643","72321.0"
"2","HashShuffleAppenderWrapper.java","143976","336073","480049","143976","71988.0"
"2","BSTIndex.java","82247","213251","295498","82247","41123.0"
"2","IndexMethod.java","0","0","0","0","0"
"2","IndexReader.java","0","0","0","0","0"
"2","IndexWriter.java","0","0","0","0","0"
"2","OrderIndexReader.java","0","0","0","0","0"
"2","JsonLineDeserializer.java","30785","43428","74213","30785","15392.0"
"2","JsonLineSerDe.java","67681","108322","176003","67681","33840.0"
"2","JsonLineSerializer.java","90613","182630","273243","90613","45306.0"
"2","ORCAppender.java","5455","17689","23144","5455","2727.0"
"2","OrcScanner.java","0","0","0","0","0"
"2","package-info.java","0","0","0","0","0"
"2","package-info.java","0","0","0","0","0"
"2","ParquetAppender.java","117052","166047","283099","117052","58526.0"
"2","ParquetScanner.java","149994","354731","504725","149994","74997.0"
"2","TajoParquetReader.java","0","0","0","0","0"
"2","TajoParquetWriter.java","0","0","0","0","0"
"2","TajoReadSupport.java","143723","275412","419135","143723","71861.0"
"2","TajoRecordConverter.java","129306","249879","379185","129306","64653.0"
"2","TajoRecordMaterializer.java","153299","402479","555778","153299","76649.0"
"2","TajoSchemaConverter.java","0","0","0","0","0"
"2","TajoWriteSupport.java","149474","309432","458906","149474","74737.0"
"2","DirectRawFileScanner.java","105778","116572","222350","105778","52889.0"
"2","DirectRawFileWriter.java","4513","9802","14315","4513","2256.0"
"2","RawFile.java","82121","212689","294810","82121","41060.0"
"2","BytesRefArrayWritable.java","0","0","0","0","0"
"2","BytesRefWritable.java","0","0","0","0","0"
"2","ColumnProjectionUtils.java","0","0","0","0","0"
"2","LazyDecompressionCallback.java","0","0","0","0","0"
"2","NonSyncByteArrayInputStream.java","0","0","0","0","0"
"2","NonSyncByteArrayOutputStream.java","0","0","0","0","0"
"2","NonSyncDataInputBuffer.java","0","0","0","0","0"
"2","NonSyncDataOutputBuffer.java","0","0","0","0","0"
"2","RCFile.java","114479","207838","322317","114479","57239.0"
"2","SchemaAwareCompressionInputStream.java","0","0","0","0","0"
"2","SchemaAwareCompressionOutputStream.java","0","0","0","0","0"
"2","RegexLineDeserializer.java","0","0","0","0","0"
"2","RegexLineSerDe.java","0","0","0","0","0"
"2","RegexLineSerializer.java","0","0","0","0","0"
"2","SequenceFileAppender.java","117575","153642","271217","117575","58787.0"
"2","SequenceFileScanner.java","117689","156937","274626","117689","58844.0"
"2","ByteBufLineReader.java","4085","11290","15375","4085","2042.0"
"2","CSVLineDeserializer.java","57980","81059","139039","57980","28990.0"
"2","CSVLineSerDe.java","66186","103979","170165","66186","33093.0"
"2","CSVLineSerializer.java","57980","81059","139039","57980","28990.0"
"2","DelimitedLineReader.java","7451","16021","23472","7451","3725.0"
"2","DelimitedTextFile.java","3738","10411","14149","3738","1869.0"
"2","FieldSplitProcessor.java","0","0","0","0","0"
"2","LineSplitProcessor.java","0","0","0","0","0"
"2","MultiBytesFieldSplitProcessor.java","0","0","0","0","0"
"2","TextFieldSerializerDeserializer.java","1479","7317","8796","1479","739.0"
"2","TextLineDeserializer.java","66186","103979","170165","66186","33093.0"
"2","TextLineParsingError.java","0","0","0","0","0"
"2","TextLineSerDe.java","66186","103979","170165","66186","33093.0"
"2","TextLineSerializer.java","1668","4550","6218","1668","834.0"
"2","ByteBufferAllocatorPool.java","0","0","0","0","0"
"2","ByteBufferPoolAdapter.java","0","0","0","0","0"
"2","OrcConf.java","0","0","0","0","0"
"2","OrcFile.java","0","0","0","0","0"
"2","OrcRecordReader.java","0","0","0","0","0"
"2","OrcUtils.java","0","0","0","0","0"
"2","package-info.java","0","0","0","0","0"
"2","RecordReaderUtils.java","0","0","0","0","0"
"2","TreeReaderFactory.java","0","0","0","0","0"
"2","BloomFilter.java","0","0","0","0","0"
"2","Murmur3.java","0","0","0","0","0"
"2","Writer.java","0","0","0","0","0"
"2","WriterImpl.java","0","0","0","0","0"
"2","ZeroCopyAdapter.java","0","0","0","0","0"
"2","InternalParquetRecordReader.java","0","0","0","0","0"
"2","ParquetReader.java","0","0","0","0","0"
"2","HttpFileServer.java","57242","79043","136285","57242","28621.0"
"2","HttpFileServerChannelInitializer.java","0","0","0","0","0"
"2","HttpFileServerHandler.java","57242","79043","136285","57242","28621.0"
"2","TestAvroUtil.java","129588","258715","388303","129588","64794.0"
"2","TestBSTIndex.java","82577","284823","367400","82577","41288.0"
"2","TestSingleCSVFileBSTIndex.java","82577","284823","367400","82577","41288.0"
"2","TestJsonSerDe.java","122663","219137","341800","122663","61331.0"
"2","TestReadWrite.java","117131","214315","331446","117131","58565.0"
"2","TestSchemaConverter.java","0","0","0","0","0"
"2","TestDirectRawFile.java","105778","116572","222350","105778","52889.0"
"2","TestRegexSerDe.java","0","0","0","0","0"
"2","TestByteBufLineReader.java","0","0","0","0","0"
"2","TestCompressionStorages.java","78948","214233","293181","78948","39474.0"
"2","TestDelimitedTextFile.java","31079","43203","74282","31079","15539.0"
"2","TestFileSystems.java","30172","43507","73679","30172","15086.0"
"2","TestFileTablespace.java","82600","306204","388804","82600","41300.0"
"2","TestLineReader.java","4085","11290","15375","4085","2042.0"
"2","TestMergeScanner.java","83578","335331","418909","83578","41789.0"
"2","TestSplitProcessor.java","58383","88135","146518","58383","29191.0"
"2","TestStorages.java","82121","210354","292475","82121","41060.0"
"2","TestStorageUtil.java","0","0","0","0","0"
"2","ConnectionInfo.java","0","0","0","0","0"
"2","JdbcFragment.java","0","0","0","0","0"
"2","JdbcFragmentSerde.java","0","0","0","0","0"
"2","JdbcMetadataProviderBase.java","0","0","0","0","0"
"2","JdbcScanner.java","0","0","0","0","0"
"2","JdbcTablespace.java","0","0","0","0","0"
"2","SQLBuilder.java","0","0","0","0","0"
"2","SQLExpressionGenerator.java","0","0","0","0","0"
"2","TestConnectionInfo.java","0","0","0","0","0"
"2","KafkaFragment.java","0","0","0","0","0"
"2","KafkaFragmentSerde.java","0","0","0","0","0"
"2","KafkaScanner.java","0","0","0","0","0"
"2","KafkaStorageConstants.java","0","0","0","0","0"
"2","KafkaTablespace.java","0","0","0","0","0"
"2","SimpleConsumerManager.java","0","0","0","0","0"
"2","KafkaTestUtil.java","0","0","0","0","0"
"2","EmbeddedKafka.java","0","0","0","0","0"
"2","EmbeddedZookeeper.java","0","0","0","0","0"
"2","TestKafkaQuery.java","0","0","0","0","0"
"2","TestKafkaScanner.java","0","0","0","0","0"
"2","TestKafkaTablespace.java","0","0","0","0","0"
"2","TestSimpleConsumerManager.java","0","0","0","0","0"
"2","PgSQLJdbcScanner.java","0","0","0","0","0"
"2","PgSQLMetadataProvider.java","0","0","0","0","0"
"2","PgSQLTablespace.java","0","0","0","0","0"
"2","PgSQLTestServer.java","0","0","0","0","0"
"2","TestPgSQLEndPointTests.java","0","0","0","0","0"
"2","TestPgSQLJdbcTableSpace.java","446","708","1154","446","223.0"
"2","TestPgSQLMetadataProvider.java","0","0","0","0","0"
"2","TestPgSQLQueryTests.java","0","0","0","0","0"
"2","TestPgSQLSimpleQueryTests.java","0","0","0","0","0"
"2","AnonymousAWSCredentialsProvider.java","0","0","0","0","0"
"2","BasicAWSCredentialsProvider.java","0","0","0","0","0"
"2","S3TableSpace.java","1998","1485","3483","1998","999.0"
"2","TajoS3Constants.java","0","0","0","0","0"
"2","MockAmazonS3.java","0","0","0","0","0"
"2","MockObjectListing.java","0","0","0","0","0"
"2","MockS3FileSystem.java","0","0","0","0","0"
"2","TestS3TableSpace.java","0","0","0","0","0"
"2","ExampleHttpFileFragment.java","0","0","0","0","0"
"2","ExampleHttpFileFragmentSerde.java","0","0","0","0","0"
"2","ExampleHttpFileTablespace.java","0","0","0","0","0"
"2","ExampleHttpJsonLineReader.java","0","0","0","0","0"
"2","ExampleHttpJsonScanner.java","0","0","0","0","0"
"2","ExampleHttpServerHandler.java","0","0","0","0","0"
"2","ExampleHttpServerInitializer.java","0","0","0","0","0"
"2","ExampleHttpTablespaceTestServer.java","0","0","0","0","0"
"2","TestExampleHttpFileQuery.java","0","0","0","0","0"
"2","AnnotationVisitor.java","0","0","0","0","0"
"2","AnnotationWriter.java","0","0","0","0","0"
"2","Attribute.java","0","0","0","0","0"
"2","ByteVector.java","0","0","0","0","0"
"2","ClassReader.java","0","0","0","0","0"
"2","ClassVisitor.java","0","0","0","0","0"
"2","ClassWriter.java","0","0","0","0","0"
"2","AdviceAdapter.java","0","0","0","0","0"
"2","AnalyzerAdapter.java","145946","289520","435466","145946","72973.0"
"2","CodeSizeEvaluator.java","0","0","0","0","0"
"2","GeneratorAdapter.java","0","0","0","0","0"
"2","InstructionAdapter.java","0","0","0","0","0"
"2","JSRInlinerAdapter.java","145946","289520","435466","145946","72973.0"
"2","LocalVariablesSorter.java","0","0","0","0","0"
"2","Method.java","0","0","0","0","0"
"2","Remapper.java","0","0","0","0","0"
"2","RemappingAnnotationAdapter.java","0","0","0","0","0"
"2","RemappingClassAdapter.java","0","0","0","0","0"
"2","RemappingFieldAdapter.java","0","0","0","0","0"
"2","RemappingMethodAdapter.java","0","0","0","0","0"
"2","RemappingSignatureAdapter.java","0","0","0","0","0"
"2","SerialVersionUIDAdder.java","0","0","0","0","0"
"2","SimpleRemapper.java","0","0","0","0","0"
"2","StaticInitMerger.java","0","0","0","0","0"
"2","TableSwitchGenerator.java","0","0","0","0","0"
"2","TryCatchBlockSorter.java","0","0","0","0","0"
"2","Context.java","0","0","0","0","0"
"2","Edge.java","0","0","0","0","0"
"2","FieldVisitor.java","0","0","0","0","0"
"2","FieldWriter.java","0","0","0","0","0"
"2","Frame.java","0","0","0","0","0"
"2","Handle.java","0","0","0","0","0"
"2","Handler.java","0","0","0","0","0"
"2","Item.java","0","0","0","0","0"
"2","Label.java","0","0","0","0","0"
"2","MethodVisitor.java","0","0","0","0","0"
"2","MethodWriter.java","0","0","0","0","0"
"2","Opcodes.java","0","0","0","0","0"
"2","AnnotationConstantsCollector.java","0","0","0","0","0"
"2","ClassConstantsCollector.java","0","0","0","0","0"
"2","ClassOptimizer.java","0","0","0","0","0"
"2","Constant.java","0","0","0","0","0"
"2","ConstantPool.java","0","0","0","0","0"
"2","FieldConstantsCollector.java","0","0","0","0","0"
"2","JarOptimizer.java","0","0","0","0","0"
"2","MethodConstantsCollector.java","0","0","0","0","0"
"2","MethodOptimizer.java","0","0","0","0","0"
"2","NameMapping.java","0","0","0","0","0"
"2","Shrinker.java","0","0","0","0","0"
"2","SignatureReader.java","0","0","0","0","0"
"2","SignatureVisitor.java","0","0","0","0","0"
"2","SignatureWriter.java","0","0","0","0","0"
"2","AbstractInsnNode.java","0","0","0","0","0"
"2","Analyzer.java","145946","289520","435466","145946","72973.0"
"2","AnalyzerException.java","0","0","0","0","0"
"2","BasicInterpreter.java","0","0","0","0","0"
"2","BasicValue.java","0","0","0","0","0"
"2","BasicVerifier.java","0","0","0","0","0"
"2","Frame.java","0","0","0","0","0"
"2","Interpreter.java","0","0","0","0","0"
"2","SimpleVerifier.java","0","0","0","0","0"
"2","SmallSet.java","0","0","0","0","0"
"2","SourceInterpreter.java","0","0","0","0","0"
"2","SourceValue.java","0","0","0","0","0"
"2","Subroutine.java","0","0","0","0","0"
"2","Value.java","0","0","0","0","0"
"2","AnnotationNode.java","0","0","0","0","0"
"2","ClassNode.java","0","0","0","0","0"
"2","FieldInsnNode.java","0","0","0","0","0"
"2","FieldNode.java","0","0","0","0","0"
"2","FrameNode.java","0","0","0","0","0"
"2","IincInsnNode.java","0","0","0","0","0"
"2","InnerClassNode.java","0","0","0","0","0"
"2","InsnList.java","0","0","0","0","0"
"2","InsnNode.java","0","0","0","0","0"
"2","IntInsnNode.java","0","0","0","0","0"
"2","InvokeDynamicInsnNode.java","0","0","0","0","0"
"2","JumpInsnNode.java","0","0","0","0","0"
"2","LabelNode.java","0","0","0","0","0"
"2","LdcInsnNode.java","0","0","0","0","0"
"2","LineNumberNode.java","0","0","0","0","0"
"2","LocalVariableNode.java","0","0","0","0","0"
"2","LookupSwitchInsnNode.java","0","0","0","0","0"
"2","MethodInsnNode.java","0","0","0","0","0"
"2","MethodNode.java","0","0","0","0","0"
"2","MultiANewArrayInsnNode.java","0","0","0","0","0"
"2","TableSwitchInsnNode.java","0","0","0","0","0"
"2","TryCatchBlockNode.java","0","0","0","0","0"
"2","TypeInsnNode.java","0","0","0","0","0"
"2","VarInsnNode.java","0","0","0","0","0"
"2","Type.java","0","0","0","0","0"
"2","ASMifiable.java","0","0","0","0","0"
"2","ASMifier.java","0","0","0","0","0"
"2","CheckAnnotationAdapter.java","0","0","0","0","0"
"2","CheckClassAdapter.java","0","0","0","0","0"
"2","CheckFieldAdapter.java","0","0","0","0","0"
"2","CheckMethodAdapter.java","145946","289520","435466","145946","72973.0"
"2","CheckSignatureAdapter.java","0","0","0","0","0"
"2","Printer.java","0","0","0","0","0"
"2","Textifiable.java","0","0","0","0","0"
"2","Textifier.java","0","0","0","0","0"
"2","TraceAnnotationVisitor.java","0","0","0","0","0"
"2","TraceClassVisitor.java","0","0","0","0","0"
"2","TraceFieldVisitor.java","0","0","0","0","0"
"2","TraceMethodVisitor.java","0","0","0","0","0"
"2","TraceSignatureVisitor.java","0","0","0","0","0"
"2","ASMContentHandler.java","145946","289520","435466","145946","72973.0"
"2","Processor.java","0","0","0","0","0"
"2","SAXAdapter.java","0","0","0","0","0"
"2","SAXAnnotationAdapter.java","0","0","0","0","0"
"2","SAXClassAdapter.java","0","0","0","0","0"
"2","SAXCodeAdapter.java","0","0","0","0","0"
"2","SAXFieldAdapter.java","0","0","0","0","0"
"2","FadvisedChunkedFile.java","84814","126137","210951","84814","42407.0"
"2","FadvisedFileRegion.java","84814","126137","210951","84814","42407.0"
"2","FileCloseListener.java","144714","284640","429354","144714","72357.0"
"2","TajoPullServerService.java","79274","207845","287119","79274","39637.0"
"3","Aggregation.java","0","0","0","0","0"
"3","AlterTable.java","145048","281457","426505","145048","48349.0"
"3","AlterTableOpType.java","0","0","0","0","0"
"3","AlterTablespace.java","0","0","0","0","0"
"3","AlterTablespaceSetType.java","0","0","0","0","0"
"3","BetweenPredicate.java","0","0","0","0","0"
"3","BinaryOperator.java","0","0","0","0","0"
"3","BooleanLiteral.java","0","0","0","0","0"
"3","CaseWhenPredicate.java","0","0","0","0","0"
"3","CastExpr.java","0","0","0","0","0"
"3","ColumnDefinition.java","0","0","0","0","0"
"3","ColumnReferenceExpr.java","0","0","0","0","0"
"3","CommonSubquery.java","0","0","0","0","0"
"3","CountRowsFunctionExpr.java","0","0","0","0","0"
"3","CreateDatabase.java","0","0","0","0","0"
"3","CreateIndex.java","0","0","0","0","0"
"3","CreateTable.java","75706","291206","366912","127266","42422.0"
"3","DataTypeExpr.java","92143","310481","402624","127179","42393.0"
"3","DateLiteral.java","0","0","0","0","0"
"3","DateValue.java","0","0","0","0","0"
"3","DropDatabase.java","0","0","0","0","0"
"3","DropIndex.java","0","0","0","0","0"
"3","DropTable.java","0","0","0","0","0"
"3","ExistsPredicate.java","0","0","0","0","0"
"3","Explain.java","152138","291070","443208","152138","50712.0"
"3","Expr.java","0","0","0","0","0"
"3","ExprVisitor.java","0","0","0","0","0"
"3","FunctionExpr.java","0","0","0","0","0"
"3","GeneralSetFunctionExpr.java","0","0","0","0","0"
"3","Having.java","0","0","0","0","0"
"3","InPredicate.java","0","0","0","0","0"
"3","Insert.java","82480","385005","467485","82480","27493.0"
"3","IntervalLiteral.java","0","0","0","0","0"
"3","IsNullPredicate.java","0","0","0","0","0"
"3","Join.java","0","0","0","0","0"
"3","JoinType.java","0","0","0","0","0"
"3","JsonHelper.java","0","0","0","0","0"
"3","JsonSerializable.java","0","0","0","0","0"
"3","Limit.java","0","0","0","0","0"
"3","LiteralValue.java","0","0","0","0","0"
"3","NamedExpr.java","0","0","0","0","0"
"3","NotExpr.java","0","0","0","0","0"
"3","NullLiteral.java","0","0","0","0","0"
"3","OpType.java","0","0","0","0","0"
"3","PatternMatchPredicate.java","0","0","0","0","0"
"3","Projection.java","0","0","0","0","0"
"3","QualifiedAsteriskExpr.java","0","0","0","0","0"
"3","Relation.java","77329","389852","467181","77329","25776.0"
"3","RelationList.java","77329","389852","467181","77329","25776.0"
"3","ScalarSubQuery.java","0","0","0","0","0"
"3","Selection.java","0","0","0","0","0"
"3","SetOperation.java","0","0","0","0","0"
"3","SetSession.java","0","0","0","0","0"
"3","SignedExpr.java","0","0","0","0","0"
"3","SimpleTableSubquery.java","84209","390783","474992","84209","28069.0"
"3","Sort.java","84587","423733","508320","127179","42393.0"
"3","TablePrimarySubQuery.java","84209","390783","474992","84209","28069.0"
"3","TimeLiteral.java","0","0","0","0","0"
"3","TimestampLiteral.java","0","0","0","0","0"
"3","TimeValue.java","0","0","0","0","0"
"3","TruncateTable.java","0","0","0","0","0"
"3","UnaryOperator.java","0","0","0","0","0"
"3","ValueListExpr.java","0","0","0","0","0"
"3","Window.java","0","0","0","0","0"
"3","WindowFunctionExpr.java","0","0","0","0","0"
"3","WindowSpec.java","69654","171066","240720","69654","23218.0"
"3","AlgebraTestingUtil.java","0","0","0","0","0"
"3","TestExpr.java","0","0","0","0","0"
"3","AbstractCatalogClient.java","82592","294528","377120","128300","42766.0"
"3","CatalogClient.java","83576","334269","417845","83576","27858.0"
"3","AlreadyRegisteredURIException.java","0","0","0","0","0"
"3","AlterTableDesc.java","148386","292901","441287","148386","49462.0"
"3","AlterTableType.java","0","0","0","0","0"
"3","AttributeType.java","0","0","0","0","0"
"3","CatalogConstants.java","0","0","0","0","0"
"3","CatalogService.java","141417","282149","423566","141417","47139.0"
"3","CatalogUtil.java","82595","298135","380730","128768","42922.0"
"3","Column.java","82779","315961","398740","82779","27593.0"
"3","DDLBuilder.java","99690","310122","409812","99690","33230.0"
"3","FieldConverter.java","0","0","0","0","0"
"3","FunctionDesc.java","84208","389145","473353","129084","43028.0"
"3","FunctionDescBuilder.java","0","0","0","0","0"
"3","IndexDesc.java","84059","384589","468648","84059","28019.0"
"3","IndexMeta.java","0","0","0","0","0"
"3","CatalogGsonHelper.java","0","0","0","0","0"
"3","FunctionAdapter.java","0","0","0","0","0"
"3","SchemaAdapter.java","0","0","0","0","0"
"3","TableMetaAdapter.java","82589","292140","374729","82589","27529.0"
"3","ListSchemaBuilder.java","0","0","0","0","0"
"3","MetadataProvider.java","110444","136696","247140","110444","36814.0"
"3","NestedPathUtil.java","0","0","0","0","0"
"3","PartitionDesc.java","129979","310376","440355","129979","43326.0"
"3","PartitionMethodDesc.java","0","0","0","0","0"
"3","Schema.java","83578","335331","418909","83578","27859.0"
"3","SchemaBuilder.java","0","0","0","0","0"
"3","SchemaFactory.java","0","0","0","0","0"
"3","SchemaLegacy.java","0","0","0","0","0"
"3","SchemaObject.java","0","0","0","0","0"
"3","SchemaUtil.java","82577","284823","367400","128111","42703.0"
"3","SetSchemaBuilder.java","0","0","0","0","0"
"3","SortSpec.java","84587","423733","508320","84587","28195.0"
"3","ColumnStats.java","0","0","0","0","0"
"3","Stat.java","0","0","0","0","0"
"3","StatisticsUtil.java","0","0","0","0","0"
"3","StatSet.java","0","0","0","0","0"
"3","TableStats.java","84547","417220","501767","123852","41284.0"
"3","TableDesc.java","111257","284113","395370","111257","37085.0"
"3","TableMeta.java","113467","328010","441477","113467","37822.0"
"3","TypeConverter.java","0","0","0","0","0"
"3","TypeDesc.java","0","0","0","0","0"
"3","DataTypeUtil.java","0","0","0","0","0"
"3","ClassBaseInvocationDesc.java","0","0","0","0","0"
"3","Function.java","0","0","0","0","0"
"3","FunctionCollection.java","0","0","0","0","0"
"3","FunctionInvocation.java","92487","142115","234602","92487","30829.0"
"3","FunctionSignature.java","93100","145230","238330","93100","31033.0"
"3","FunctionSupplement.java","0","0","0","0","0"
"3","FunctionUtil.java","93100","145230","238330","93100","31033.0"
"3","ScalarFunction.java","0","0","0","0","0"
"3","StaticMethodInvocationDesc.java","0","0","0","0","0"
"3","UDFInvocationDesc.java","1668","4550","6218","1668","556.0"
"3","TestColumnStat.java","0","0","0","0","0"
"3","TestStatisticsUtil.java","0","0","0","0","0"
"3","TestStatSet.java","0","0","0","0","0"
"3","TestTableStat.java","0","0","0","0","0"
"3","TestCatalogUtil.java","0","0","0","0","0"
"3","TestColumn.java","0","0","0","0","0"
"3","TestFunctionDesc.java","83614","332037","415651","83614","27871.0"
"3","TestIndexDesc.java","84059","384589","468648","84059","28019.0"
"3","TestKeyValueSet.java","0","0","0","0","0"
"3","TestSchema.java","82779","315961","398740","82779","27593.0"
"3","TestTableDesc.java","83566","379726","463292","83566","27855.0"
"3","TestTableMeta.java","75228","333817","409045","75228","25076.0"
"3","HCatalogStore.java","0","0","0","0","0"
"3","HiveCatalogStore.java","112500","277070","389570","127705","42568.0"
"3","HiveCatalogStoreClientPool.java","129956","311803","441759","129956","43318.0"
"3","HiveCatalogUtil.java","115321","320368","435689","115321","38440.0"
"3","TestHiveCatalogStore.java","125552","273303","398855","125854","41951.0"
"3","CatalogServer.java","82592","294528","377120","128768","42922.0"
"3","AbstractTableDescriptor.java","0","0","0","0","0"
"3","ClusterTableDescriptor.java","0","0","0","0","0"
"3","ColumnDescriptor.java","0","0","0","0","0"
"3","ColumnsTableDescriptor.java","0","0","0","0","0"
"3","DatabasesTableDescriptor.java","0","0","0","0","0"
"3","IndexesTableDescriptor.java","0","0","0","0","0"
"3","InfoSchemaMetadataDictionary.java","46802","104730","151532","46802","15600.0"
"3","PartitionKeysTableDescriptor.java","0","0","0","0","0"
"3","PartitionsTableDescriptor.java","0","0","0","0","0"
"3","SessionTableDescriptor.java","0","0","0","0","0"
"3","TableDescriptor.java","0","0","0","0","0"
"3","TableOptionsTableDescriptor.java","0","0","0","0","0"
"3","TablespacesTableDescriptor.java","0","0","0","0","0"
"3","TablesTableDescriptor.java","0","0","0","0","0"
"3","TableStatsTableDescriptor.java","0","0","0","0","0"
"3","LinkedMetadataManager.java","109588","120665","230253","109588","36529.0"
"3","LocalCatalogWrapper.java","0","0","0","0","0"
"3","AbstractDBStore.java","126977","247165","374142","127522","42507.0"
"3","CatalogStore.java","82592","294528","377120","82592","27530.0"
"3","DerbyStore.java","101831","285344","387175","101831","33943.0"
"3","MariaDBStore.java","86193","201886","288079","86193","28731.0"
"3","MySQLStore.java","103083","315758","418841","103083","34361.0"
"3","BaseSchema.java","0","0","0","0","0"
"3","DatabaseObject.java","0","0","0","0","0"
"3","DatabaseObjectType.java","0","0","0","0","0"
"3","SchemaPatch.java","0","0","0","0","0"
"3","SQLObject.java","0","0","0","0","0"
"3","StoreObject.java","0","0","0","0","0"
"3","OracleStore.java","40175","49688","89863","40175","13391.0"
"3","PostgreSQLStore.java","39847","49818","89665","39847","13282.0"
"3","XMLCatalogSchemaManager.java","56560","78499","135059","56560","18853.0"
"3","CatalogTestingUtil.java","3578","4807","8385","3578","1192.0"
"3","MiniCatalogServer.java","0","0","0","0","0"
"3","TestXMLCatalogSchemaManager.java","41348","61884","103232","41348","13782.0"
"3","TestCatalog.java","82590","292667","375257","129704","43234.0"
"3","TestCatalogAgainstCaseSensitivity.java","4220","26048","30268","4220","1406.0"
"3","TestCatalogExceptions.java","3451","24548","27999","3451","1150.0"
"3","TestLinkedMetadataManager.java","100438","105248","205686","100438","33479.0"
"3","TajoAdmin.java","127039","294561","421600","128892","42964.0"
"3","TajoDump.java","99323","275431","374754","119256","39752.0"
"3","TajoGetConf.java","0","0","0","0","0"
"3","TajoHAAdmin.java","82345","174806","257151","82345","27448.0"
"3","CliClientParamsFactory.java","0","0","0","0","0"
"3","ConnectDatabaseCommand.java","148691","362497","511188","148691","49563.0"
"3","CopyrightCommand.java","0","0","0","0","0"
"3","DescFunctionCommand.java","135281","316453","451734","135281","45093.0"
"3","DescTableCommand.java","136417","367194","503611","136417","45472.0"
"3","ExecExternalShellCommand.java","0","0","0","0","0"
"3","ExitCommand.java","0","0","0","0","0"
"3","HdfsCommand.java","0","0","0","0","0"
"3","HelpCommand.java","131491","289858","421349","131491","43830.0"
"3","ListDatabaseCommand.java","0","0","0","0","0"
"3","SetCommand.java","126270","236136","362406","126270","42090.0"
"3","TajoAdminCommand.java","131588","230366","361954","131588","43862.0"
"3","TajoGetConfCommand.java","40262","105070","145332","40262","13420.0"
"3","TajoHAAdminCommand.java","82011","174358","256369","82011","27337.0"
"3","TajoShellCommand.java","129943","257266","387209","129943","43314.0"
"3","UnsetCommand.java","0","0","0","0","0"
"3","VersionCommand.java","0","0","0","0","0"
"3","DefaultTajoCliOutputFormatter.java","43602","142814","186416","43602","14534.0"
"3","InvalidStatementException.java","0","0","0","0","0"
"3","ParsedResult.java","0","0","0","0","0"
"3","SimpleParser.java","141656","283172","424828","141656","47218.0"
"3","TajoCli.java","82572","279648","362220","128821","42940.0"
"3","TajoCliOutputFormatter.java","0","0","0","0","0"
"3","TajoFileHistory.java","82703","312530","395233","82703","27567.0"
"3","CatalogAdminClient.java","85925","189379","275304","85925","28641.0"
"3","CatalogAdminClientImpl.java","64266","117883","182149","64266","21422.0"
"3","ClientParameterHelper.java","0","0","0","0","0"
"3","ClientParameters.java","0","0","0","0","0"
"3","DummyServiceTracker.java","19961","43005","62966","19961","6653.0"
"3","InvalidClientSessionException.java","84062","386860","470922","84062","28020.0"
"3","QueryClient.java","5813","15959","21772","5813","1937.0"
"3","QueryClientImpl.java","5813","15959","21772","5813","1937.0"
"3","QueryStatus.java","0","0","0","0","0"
"3","ResultSetUtil.java","123513","274372","397885","123513","41171.0"
"3","SessionConnection.java","10010","25416","35426","10010","3336.0"
"3","TajoClient.java","97990","103158","201148","97990","32663.0"
"3","TajoClientImpl.java","5813","15959","21772","5813","1937.0"
"3","TajoClientUtil.java","10010","25416","35426","10010","3336.0"
"3","ClientDelegate.java","0","0","0","0","0"
"3","ClientDelegateFactory.java","0","0","0","0","0"
"3","ClientUtil.java","0","0","0","0","0"
"3","ClientConnectionException.java","0","0","0","0","0"
"3","ClientUnableToConnectException.java","0","0","0","0","0"
"3","FutureListener.java","0","0","0","0","0"
"3","LegacyClientDelegate.java","3446","5585","9031","3446","1148.0"
"3","QueryFuture.java","0","0","0","0","0"
"3","QueryState.java","0","0","0","0","0"
"3","ServiceDiscovery.java","0","0","0","0","0"
"3","TajoClient.java","97990","103158","201148","97990","32663.0"
"3","FetchResultSet.java","83970","122968","206938","83970","27990.0"
"3","MetaDataTuple.java","137868","356609","494477","137868","45956.0"
"3","TajoMemoryResultSet.java","149253","281327","430580","149253","49751.0"
"3","TajoMetaDataResultSet.java","0","0","0","0","0"
"3","TajoResultSetBase.java","114961","285650","400611","114961","38320.0"
"3","TajoResultSetMetaData.java","0","0","0","0","0"
"3","TajoSQLException.java","0","0","0","0","0"
"3","WaitingResultSet.java","0","0","0","0","0"
"3","RowStoreUtil.java","82577","284823","367400","122082","40694.0"
"3","TableExample.java","0","0","0","0","0"
"3","TajoClientAsyncExample.java","0","0","0","0","0"
"3","TajoClientExample.java","0","0","0","0","0"
"3","BackendTestingUtil.java","90361","388943","479304","90361","30120.0"
"3","CatalogTestingUtil.java","3578","4807","8385","3578","1192.0"
"3","HBaseTestClusterUtil.java","24","192","216","24","8.0"
"3","IntegrationTest.java","0","0","0","0","0"
"3","LocalTajoTestingUtility.java","68121","93213","161334","113665","37888.0"
"3","NamedTest.java","0","0","0","0","0"
"3","QueryTestCaseBase.java","126076","276244","402320","126076","42025.0"
"3","TajoTestingCluster.java","82572","279648","362220","116582","38860.0"
"3","TpchTestBase.java","84219","392901","477120","84219","28073.0"
"3","NotNull.java","0","0","0","0","0"
"3","NotThreadSafe.java","0","0","0","0","0"
"3","Nullable.java","0","0","0","0","0"
"3","ThreadSafe.java","0","0","0","0","0"
"3","Assert.java","0","0","0","0","0"
"3","UserRoleInfo.java","0","0","0","0","0"
"3","BuiltinStorages.java","0","0","0","0","0"
"3","ProtoObject.java","0","0","0","0","0"
"3","Sleeper.java","0","0","0","0","0"
"3","IPv4.java","0","0","0","0","0"
"3","TajoTypeUtil.java","0","0","0","0","0"
"3","TimeRange.java","0","0","0","0","0"
"3","TajoConf.java","82575","281371","363946","116395","38798.0"
"3","ConfigKey.java","0","0","0","0","0"
"3","AnyDatum.java","0","0","0","0","0"
"3","BitDatum.java","0","0","0","0","0"
"3","BlobDatum.java","83614","332037","415651","83614","27871.0"
"3","BooleanDatum.java","0","0","0","0","0"
"3","CharDatum.java","0","0","0","0","0"
"3","DateDatum.java","125538","317448","442986","128918","42972.0"
"3","Datum.java","131844","399778","531622","131844","43948.0"
"3","DatumFactory.java","75988","293368","369356","126804","42268.0"
"3","Float4Datum.java","83604","328468","412072","127967","42655.0"
"3","Float8Datum.java","83604","328468","412072","127967","42655.0"
"3","Int2Datum.java","83604","328468","412072","127967","42655.0"
"3","Int4Datum.java","83604","328468","412072","127967","42655.0"
"3","Int8Datum.java","83604","328468","412072","127967","42655.0"
"3","IntervalDatum.java","84600","225198","309798","84600","28200.0"
"3","NullDatum.java","0","0","0","0","0"
"3","NumericDatum.java","0","0","0","0","0"
"3","AbstractCharBasedFormatter.java","0","0","0","0","0"
"3","ProtobufFormatter.java","0","0","0","0","0"
"3","ProtobufJsonFormat.java","0","0","0","0","0"
"3","TextUtils.java","96263","306594","402857","96263","32087.0"
"3","ProtobufDatum.java","0","0","0","0","0"
"3","ProtobufDatumFactory.java","98160","405035","503195","98160","32720.0"
"3","TextDatum.java","83603","320421","404024","126650","42216.0"
"3","TimeDatum.java","125689","317250","442939","125998","41999.0"
"3","TimestampDatum.java","125364","318356","443720","128837","42945.0"
"3","AmbiguousColumnException.java","0","0","0","0","0"
"3","AmbiguousFunctionException.java","3446","5585","9031","3446","1148.0"
"3","AmbiguousPartitionDirectoryExistException.java","24737","27752","52489","24737","8245.0"
"3","AmbiguousTableException.java","0","0","0","0","0"
"3","CannotDropCurrentDatabaseException.java","84547","420781","505328","84547","28182.0"
"3","CatalogUpgradeRequiredException.java","84208","389145","473353","84208","28069.0"
"3","DataTypeMismatchException.java","84062","386860","470922","84062","28020.0"
"3","DefaultTajoException.java","84208","389145","473353","84208","28069.0"
"3","DividedByZeroException.java","84547","420781","505328","84547","28182.0"
"3","DuplicateColumnException.java","83983","380705","464688","83983","27994.0"
"3","DuplicateDatabaseException.java","83983","380705","464688","83983","27994.0"
"3","DuplicateFunctionException.java","84062","386860","470922","84062","28020.0"
"3","DuplicateIndexException.java","84208","389145","473353","84208","28069.0"
"3","DuplicatePartitionException.java","84208","389145","473353","84208","28069.0"
"3","DuplicateTableException.java","84208","389145","473353","84208","28069.0"
"3","DuplicateTablespaceException.java","83983","380705","464688","83983","27994.0"
"3","ErrorMessages.java","1011","1614","2625","1011","337.0"
"3","ErrorUtil.java","0","0","0","0","0"
"3","ExceptionUtil.java","11470","19685","31155","11470","3823.0"
"3","InsufficientPrivilegeException.java","3254","3963","7217","3254","1084.0"
"3","InvalidAddressException.java","0","0","0","0","0"
"3","InvalidDataTypeException.java","114440","374153","488593","114440","38146.0"
"3","InvalidInputsForCrossJoin.java","0","0","0","0","0"
"3","InvalidNameException.java","83983","380705","464688","83983","27994.0"
"3","InvalidOperationException.java","0","0","0","0","0"
"3","InvalidSessionException.java","84062","386860","470922","84062","28020.0"
"3","InvalidSessionVariableException.java","84547","420781","505328","84547","28182.0"
"3","InvalidTablePropertyException.java","84062","386860","470922","84062","28020.0"
"3","InvalidURLException.java","84547","420781","505328","84547","28182.0"
"3","InvalidValueForCastException.java","84377","410628","495005","84377","28125.0"
"3","LMDNoMatchedDatatypeException.java","84062","386860","470922","84062","28020.0"
"3","MetadataConnectionException.java","83983","380705","464688","83983","27994.0"
"3","MissingTablePropertyException.java","84062","386860","470922","84062","28020.0"
"3","NoSuchSessionVariableException.java","83983","380705","464688","83983","27994.0"
"3","NotImplementedException.java","0","0","0","0","0"
"3","QueryFailedException.java","84062","386860","470922","84062","28020.0"
"3","QueryKilledException.java","84062","386860","470922","84062","28020.0"
"3","QueryNotFoundException.java","84062","386860","470922","84062","28020.0"
"3","ReturnStateUtil.java","7595","11403","18998","7595","2531.0"
"3","SQLExceptionUtil.java","8785","14861","23646","8785","2928.0"
"3","SQLSyntaxError.java","0","0","0","0","0"
"3","TajoError.java","8785","14861","23646","8785","2928.0"
"3","TajoException.java","8785","14861","23646","8785","2928.0"
"3","TajoInternalError.java","114440","374153","488593","114440","38146.0"
"3","TajoRuntimeException.java","1011","1614","2625","1011","337.0"
"3","TooLargeInputForCrossJoinException.java","0","0","0","0","0"
"3","UnavailableTableLocationException.java","84062","386860","470922","84062","28020.0"
"3","UndefinedColumnException.java","83983","380705","464688","83983","27994.0"
"3","UndefinedDatabaseException.java","83983","380705","464688","83983","27994.0"
"3","UndefinedFunctionException.java","84062","386860","470922","84062","28020.0"
"3","UndefinedIndexException.java","83983","380705","464688","83983","27994.0"
"3","UndefinedOperatorException.java","114440","374153","488593","114440","38146.0"
"3","UndefinedPartitionException.java","0","0","0","0","0"
"3","UndefinedPartitionKeyException.java","24737","27752","52489","24737","8245.0"
"3","UndefinedPartitionMethodException.java","24737","27752","52489","24737","8245.0"
"3","UndefinedTableException.java","83983","380705","464688","83983","27994.0"
"3","UndefinedTablespaceException.java","83983","380705","464688","83983","27994.0"
"3","UndefinedTablespaceHandlerException.java","0","0","0","0","0"
"3","UnknownDataFormatException.java","84062","386860","470922","84062","28020.0"
"3","UnremovableTablePropertyException.java","0","0","0","0","0"
"3","UnsupportedCatalogStore.java","0","0","0","0","0"
"3","UnsupportedDataTypeException.java","84208","389145","473353","84208","28069.0"
"3","UnsupportedException.java","0","0","0","0","0"
"3","ValueOutOfRangeException.java","0","0","0","0","0"
"3","ValueTooLongForTypeCharactersException.java","0","0","0","0","0"
"3","ExecutionBlockId.java","0","0","0","0","0"
"3","HAConstants.java","0","0","0","0","0"
"3","ClassNameSerializer.java","0","0","0","0","0"
"3","CommonGsonHelper.java","0","0","0","0","0"
"3","DataTypeAdapter.java","0","0","0","0","0"
"3","DatumAdapter.java","82589","292140","374729","125276","41758.0"
"3","GsonHelper.java","0","0","0","0","0"
"3","GsonObject.java","0","0","0","0","0"
"3","GsonSerDerAdapter.java","0","0","0","0","0"
"3","PathSerializer.java","0","0","0","0","0"
"3","TimeZoneGsonSerdeAdapter.java","0","0","0","0","0"
"3","TypeAdapter.java","0","0","0","0","0"
"3","OverridableConf.java","43624","120856","164480","43624","14541.0"
"3","QueryId.java","80935","376785","457720","80935","26978.0"
"3","QueryIdFactory.java","79968","304550","384518","79968","26656.0"
"3","QueryVars.java","0","0","0","0","0"
"3","BaseRuleProvider.java","0","0","0","0","0"
"3","CheckHadoopRuntimeVersionRule.java","0","0","0","0","0"
"3","TajoConfValidationRule.java","0","0","0","0","0"
"3","EvaluationContext.java","0","0","0","0","0"
"3","EvaluationFailedException.java","0","0","0","0","0"
"3","EvaluationResult.java","0","0","0","0","0"
"3","SelfDiagnosisRule.java","0","0","0","0","0"
"3","SelfDiagnosisRuleDefinition.java","0","0","0","0","0"
"3","SelfDiagnosisRuleEngine.java","12","123","135","12","4.0"
"3","SelfDiagnosisRuleProvider.java","0","0","0","0","0"
"3","SelfDiagnosisRuleSession.java","53844","69782","123626","53844","17948.0"
"3","SelfDiagnosisRuleVisibility.java","0","0","0","0","0"
"3","ANSISQLIdentifierPolicy.java","0","0","0","0","0"
"3","Field.java","0","0","0","0","0"
"3","Identifier.java","0","0","0","0","0"
"3","IdentifierPolicy.java","0","0","0","0","0"
"3","IdentifierUtil.java","0","0","0","0","0"
"3","package-info.java","0","0","0","0","0"
"3","PgSQLIdentifierPolicy.java","0","0","0","0","0"
"3","QualifiedIdentifier.java","0","0","0","0","0"
"3","Schema.java","83578","335331","418909","83578","27859.0"
"3","TajoIdentifierPolicy.java","0","0","0","0","0"
"3","BaseServiceTracker.java","19961","43005","62966","19961","6653.0"
"3","HAServiceTracker.java","19961","43005","62966","19961","6653.0"
"3","ServiceTracker.java","81690","172148","253838","81690","27230.0"
"3","ServiceTrackerException.java","0","0","0","0","0"
"3","ServiceTrackerFactory.java","0","0","0","0","0"
"3","TajoMasterInfo.java","0","0","0","0","0"
"3","SessionVars.java","35320","98866","134186","35320","11773.0"
"3","BufferPool.java","66502","110968","177470","66502","22167.0"
"3","EmptyTuple.java","78262","166673","244935","78262","26087.0"
"3","NullTuple.java","13886","55100","68986","13886","4628.0"
"3","StorageConstants.java","127970","223608","351578","127970","42656.0"
"3","Tuple.java","82577","284823","367400","82577","27525.0"
"3","VTuple.java","82577","284823","367400","128125","42708.0"
"3","TajoConstants.java","84547","420781","505328","84547","28182.0"
"3","TaskAttemptId.java","79968","304550","384518","79968","26656.0"
"3","TaskId.java","79968","304550","384518","79968","26656.0"
"3","BaseTupleBuilder.java","7397","11849","19246","7397","2465.0"
"3","CompactRowBlockWriter.java","1906","2605","4511","1906","635.0"
"3","DirectBufTuple.java","120694","228204","348898","120694","40231.0"
"3","FixedSizeLimitSpec.java","0","0","0","0","0"
"3","HeapRowBlockReader.java","0","0","0","0","0"
"3","HeapTuple.java","76797","166919","243716","76797","25599.0"
"3","MemoryBlock.java","0","0","0","0","0"
"3","MemoryRowBlock.java","13995","43228","57223","13995","4665.0"
"3","OffHeapRowBlockReader.java","0","0","0","0","0"
"3","OffHeapRowBlockUtils.java","13995","43228","57223","13995","4665.0"
"3","OffHeapRowBlockWriter.java","120694","228204","348898","120694","40231.0"
"3","OffHeapRowWriter.java","0","0","0","0","0"
"3","ResizableLimitSpec.java","127071","263814","390885","127071","42357.0"
"3","ResizableMemoryBlock.java","15702","45634","61336","15702","5234.0"
"3","RowBlock.java","13995","43228","57223","13995","4665.0"
"3","RowWriter.java","120694","228204","348898","120694","40231.0"
"3","UnSafeTuple.java","1712","9416","11128","1712","570.0"
"3","UnSafeTupleBytesComparator.java","0","0","0","0","0"
"3","UnSafeTupleList.java","0","0","0","0","0"
"3","ZeroCopyTuple.java","0","0","0","0","0"
"3","RowBlockReader.java","0","0","0","0","0"
"3","TupleBuilder.java","0","0","0","0","0"
"3","Any.java","0","0","0","0","0"
"3","Array.java","0","0","0","0","0"
"3","Bit.java","0","0","0","0","0"
"3","Blob.java","0","0","0","0","0"
"3","Bool.java","0","0","0","0","0"
"3","Char.java","0","0","0","0","0"
"3","Date.java","0","0","0","0","0"
"3","Float4.java","0","0","0","0","0"
"3","Float8.java","0","0","0","0","0"
"3","Int1.java","0","0","0","0","0"
"3","Int2.java","0","0","0","0","0"
"3","Int4.java","0","0","0","0","0"
"3","Int8.java","0","0","0","0","0"
"3","Interval.java","0","0","0","0","0"
"3","Map.java","0","0","0","0","0"
"3","Null.java","0","0","0","0","0"
"3","Numeric.java","0","0","0","0","0"
"3","package-info.java","0","0","0","0","0"
"3","Protobuf.java","0","0","0","0","0"
"3","Record.java","0","0","0","0","0"
"3","Text.java","0","0","0","0","0"
"3","Time.java","0","0","0","0","0"
"3","Timestamp.java","0","0","0","0","0"
"3","Type.java","0","0","0","0","0"
"3","TypeFactory.java","0","0","0","0","0"
"3","TypeParamterizedType.java","0","0","0","0","0"
"3","TypeProtobufEncoder.java","0","0","0","0","0"
"3","TypeStringEncoder.java","0","0","0","0","0"
"3","TypeVisitor.java","0","0","0","0","0"
"3","ValueParamterizedType.java","0","0","0","0","0"
"3","Varchar.java","0","0","0","0","0"
"3","StorageUnit.java","0","0","0","0","0"
"3","TimeUnit.java","0","0","0","0","0"
"3","BasicFuture.java","0","0","0","0","0"
"3","BitArray.java","0","0","0","0","0"
"3","Bytes.java","0","0","0","0","0"
"3","BytesUtils.java","80976","183251","264227","80976","26992.0"
"3","ClassSize.java","0","0","0","0","0"
"3","ClassUtil.java","131110","292989","424099","131110","43703.0"
"3","CommonTestingUtil.java","0","0","0","0","0"
"3","CompressionUtil.java","0","0","0","0","0"
"3","DateTimeConstants.java","44074","133165","177239","44074","14691.0"
"3","DateTimeFormat.java","80714","193536","274250","80714","26904.0"
"3","DateTimeUtil.java","44074","133165","177239","44074","14691.0"
"3","TimeMeta.java","80714","193536","274250","80714","26904.0"
"3","Deallocatable.java","0","0","0","0","0"
"3","FileUtil.java","83603","321083","404686","83603","27867.0"
"3","DirectedGraph.java","0","0","0","0","0"
"3","DirectedGraphCursor.java","0","0","0","0","0"
"3","DirectedGraphVisitor.java","0","0","0","0","0"
"3","Graph.java","0","0","0","0","0"
"3","SimpleDirectedGraph.java","92496","378963","471459","92496","30832.0"
"3","SimpleUndirectedGraph.java","0","0","0","0","0"
"3","UndirectedGraph.java","0","0","0","0","0"
"3","JarUtil.java","0","0","0","0","0"
"3","JavaResourceUtil.java","0","0","0","0","0"
"3","KeyValueSet.java","83566","378721","462287","113105","37701.0"
"3","MurmurHash.java","0","0","0","0","0"
"3","NetUtils.java","0","0","0","0","0"
"3","NumberUtil.java","36066","103858","139924","88828","29609.0"
"3","Pair.java","103326","262115","365441","116462","38820.0"
"3","PlatformUtil.java","0","0","0","0","0"
"3","ProtoUtil.java","128534","252668","381202","128534","42844.0"
"3","ReflectionUtil.java","82701","309764","392465","82701","27567.0"
"3","ShutdownHookManager.java","0","0","0","0","0"
"3","SizeOf.java","0","0","0","0","0"
"3","StringUtils.java","47307","153517","200824","120825","40275.0"
"3","TajoIdUtils.java","0","0","0","0","0"
"3","TUtil.java","82701","309764","392465","82701","27567.0"
"3","UnsafeComparer.java","0","0","0","0","0"
"3","UnsafeUtil.java","66053","114702","180755","66053","22017.0"
"3","UriUtil.java","0","0","0","0","0"
"3","VersionInfo.java","42415","134981","177396","42415","14138.0"
"3","AbstractValidator.java","0","0","0","0","0"
"3","BooleanValidator.java","0","0","0","0","0"
"3","ClassValidator.java","0","0","0","0","0"
"3","ConstraintViolation.java","0","0","0","0","0"
"3","ConstraintViolationException.java","53584","85811","139395","53584","17861.0"
"3","GroupValidator.java","0","0","0","0","0"
"3","JavaStringValidator.java","0","0","0","0","0"
"3","LengthValidator.java","0","0","0","0","0"
"3","MaxValidator.java","0","0","0","0","0"
"3","MinValidator.java","0","0","0","0","0"
"3","NetworkAddressValidator.java","0","0","0","0","0"
"3","NotNullValidator.java","0","0","0","0","0"
"3","PathListValidator.java","0","0","0","0","0"
"3","PathValidator.java","0","0","0","0","0"
"3","PatternValidator.java","0","0","0","0","0"
"3","RangeValidator.java","0","0","0","0","0"
"3","ShellVariableValidator.java","0","0","0","0","0"
"3","Validator.java","0","0","0","0","0"
"3","Validators.java","12862","29262","42124","12862","4287.0"
"3","TestIPv4.java","0","0","0","0","0"
"3","TestTimeRange.java","0","0","0","0","0"
"3","TestProtobufDatum.java","0","0","0","0","0"
"3","TestTextUtils.java","0","0","0","0","0"
"3","TestArithmeticOperator.java","0","0","0","0","0"
"3","TestBitDatum.java","0","0","0","0","0"
"3","TestBoolDatum.java","0","0","0","0","0"
"3","TestBytesDatum.java","0","0","0","0","0"
"3","TestCharDatum.java","0","0","0","0","0"
"3","TestDateDatum.java","122723","279611","402334","122723","40907.0"
"3","TestDatum.java","0","0","0","0","0"
"3","TestDatumFactory.java","0","0","0","0","0"
"3","TestFloat8Datum.java","0","0","0","0","0"
"3","TestFloatDatum.java","0","0","0","0","0"
"3","TestInt2Datum.java","0","0","0","0","0"
"3","TestInt4Datum.java","0","0","0","0","0"
"3","TestInt8Datum.java","0","0","0","0","0"
"3","TestIntervalDatum.java","0","0","0","0","0"
"3","TestTextDatum.java","0","0","0","0","0"
"3","TestTimeDatum.java","0","0","0","0","0"
"3","TestTimestampDatum.java","122584","280793","403377","122584","40861.0"
"3","TestRuleEngine.java","0","0","0","0","0"
"3","TestRuleSession.java","0","0","0","0","0"
"3","TestANSISQLIdentifierPolicy.java","0","0","0","0","0"
"3","TestIdentifier.java","0","0","0","0","0"
"3","TestSchema.java","82779","315961","398740","82779","27593.0"
"3","TestTajoIdentifierPolicy.java","0","0","0","0","0"
"3","TestHeapTuple.java","0","0","0","0","0"
"3","TestMemoryRowBlock.java","120694","228204","348898","120694","40231.0"
"3","TestResizableSpec.java","0","0","0","0","0"
"3","TestUnSafeTupleBytesComparator.java","0","0","0","0","0"
"3","TestBaseTupleBuilder.java","0","0","0","0","0"
"3","TestType.java","0","0","0","0","0"
"3","TestTypeEncoder.java","0","0","0","0","0"
"3","TestTypeProtobufEncoder.java","0","0","0","0","0"
"3","TestTypeStringEncoder.java","0","0","0","0","0"
"3","TestSimpleDirectedGraph.java","90841","275983","366824","90841","30280.0"
"3","TestSimpleUndirectedGraph.java","99626","272785","372411","99626","33208.0"
"3","TestBitArrayTest.java","0","0","0","0","0"
"3","TestDateTimeFormat.java","0","0","0","0","0"
"3","TestDateTimeUtil.java","44074","133165","177239","44074","14691.0"
"3","TestNumberUtil.java","0","0","0","0","0"
"3","TestStringUtil.java","0","0","0","0","0"
"3","TestUriUtil.java","0","0","0","0","0"
"3","TestValidators.java","12862","29262","42124","12862","4287.0"
"3","BenchmarkSet.java","82709","311328","394037","82709","27569.0"
"3","Driver.java","0","0","0","0","0"
"3","SimpleQuery.java","0","0","0","0","0"
"3","TPCH.java","83983","380705","464688","119650","39883.0"
"3","CaseWhenEmitter.java","0","0","0","0","0"
"3","CaseWhenSwitchGenerator.java","0","0","0","0","0"
"3","CodeGenUtils.java","0","0","0","0","0"
"3","CompilationError.java","0","0","0","0","0"
"3","EvalCodeEmitter.java","0","0","0","0","0"
"3","EvalCodeGenContext.java","0","0","0","0","0"
"3","EvalCodeGenerator.java","89742","138887","228629","89742","29914.0"
"3","ExecutorPreCompiler.java","34831","41979","76810","34831","11610.0"
"3","LegacyFunctionBindingEmitter.java","0","0","0","0","0"
"3","ScalarFunctionBindingEmitter.java","0","0","0","0","0"
"3","TajoClassLoader.java","0","0","0","0","0"
"3","TajoGeneratorAdapter.java","34831","41979","76810","34831","11610.0"
"3","VariablesPreBuilder.java","0","0","0","0","0"
"3","RangeOverflowException.java","0","0","0","0","0"
"3","Description.java","0","0","0","0","0"
"3","ParamOptionTypes.java","0","0","0","0","0"
"3","ParamTypes.java","0","0","0","0","0"
"3","AvgDouble.java","82704","312460","395164","82704","27568.0"
"3","AvgFloat.java","130887","291499","422386","130887","43629.0"
"3","AvgInt.java","130887","291499","422386","130887","43629.0"
"3","AvgLong.java","82704","312460","395164","82704","27568.0"
"3","Coalesce.java","0","0","0","0","0"
"3","CoalesceBoolean.java","0","0","0","0","0"
"3","CoalesceDate.java","0","0","0","0","0"
"3","CoalesceDouble.java","0","0","0","0","0"
"3","CoalesceLong.java","0","0","0","0","0"
"3","CoalesceString.java","0","0","0","0","0"
"3","CoalesceTime.java","0","0","0","0","0"
"3","CoalesceTimestamp.java","0","0","0","0","0"
"3","Corr.java","0","0","0","0","0"
"3","CountRows.java","0","0","0","0","0"
"3","CountValue.java","0","0","0","0","0"
"3","CountValueDistinct.java","92828","372989","465817","92828","30942.0"
"3","Date.java","0","0","0","0","0"
"3","LastValue.java","0","0","0","0","0"
"3","LastValueDate.java","0","0","0","0","0"
"3","LastValueDouble.java","0","0","0","0","0"
"3","LastValueFloat.java","0","0","0","0","0"
"3","LastValueInt.java","0","0","0","0","0"
"3","LastValueLong.java","0","0","0","0","0"
"3","LastValueString.java","0","0","0","0","0"
"3","LastValueTime.java","0","0","0","0","0"
"3","LastValueTimestamp.java","0","0","0","0","0"
"3","Lead.java","100026","202719","302745","100026","33342.0"
"3","LeadDate.java","0","0","0","0","0"
"3","LeadDouble.java","0","0","0","0","0"
"3","LeadFloat.java","0","0","0","0","0"
"3","LeadInt.java","0","0","0","0","0"
"3","LeadLong.java","0","0","0","0","0"
"3","LeadString.java","0","0","0","0","0"
"3","LeadTime.java","0","0","0","0","0"
"3","LeadTimestamp.java","0","0","0","0","0"
"3","Max.java","0","0","0","0","0"
"3","MaxDate.java","0","0","0","0","0"
"3","MaxDouble.java","130887","291499","422386","130887","43629.0"
"3","MaxFloat.java","130887","291499","422386","130887","43629.0"
"3","MaxInt.java","130887","291499","422386","130887","43629.0"
"3","MaxLong.java","0","0","0","0","0"
"3","MaxString.java","131661","290357","422018","131661","43887.0"
"3","MaxTime.java","0","0","0","0","0"
"3","MaxTimestamp.java","0","0","0","0","0"
"3","Min.java","0","0","0","0","0"
"3","MinDate.java","0","0","0","0","0"
"3","MinDouble.java","130887","291499","422386","130887","43629.0"
"3","MinFloat.java","130887","291499","422386","130887","43629.0"
"3","MinInt.java","130887","291499","422386","130887","43629.0"
"3","MinLong.java","0","0","0","0","0"
"3","MinString.java","130887","291499","422386","130887","43629.0"
"3","MinTime.java","0","0","0","0","0"
"3","MinTimestamp.java","0","0","0","0","0"
"3","RandomInt.java","0","0","0","0","0"
"3","Sleep.java","0","0","0","0","0"
"3","StdDevPop.java","7313","12999","20312","7313","2437.0"
"3","StdDevPopDouble.java","0","0","0","0","0"
"3","StdDevPopFloat.java","0","0","0","0","0"
"3","StdDevPopInt.java","0","0","0","0","0"
"3","StdDevPopLong.java","0","0","0","0","0"
"3","StdDevSamp.java","7313","12999","20312","7313","2437.0"
"3","StdDevSampDouble.java","0","0","0","0","0"
"3","StdDevSampFloat.java","0","0","0","0","0"
"3","StdDevSampInt.java","0","0","0","0","0"
"3","StdDevSampLong.java","0","0","0","0","0"
"3","StringAgg.java","0","0","0","0","0"
"3","SumDouble.java","82704","312460","395164","82704","27568.0"
"3","SumDoubleDistinct.java","0","0","0","0","0"
"3","SumFloat.java","130887","291499","422386","130887","43629.0"
"3","SumFloatDistinct.java","0","0","0","0","0"
"3","SumInt.java","0","0","0","0","0"
"3","SumIntDistinct.java","0","0","0","0","0"
"3","SumLong.java","82704","312460","395164","82704","27568.0"
"3","SumLongDistinct.java","0","0","0","0","0"
"3","Variance.java","0","0","0","0","0"
"3","VarPop.java","0","0","0","0","0"
"3","VarPopDouble.java","0","0","0","0","0"
"3","VarPopFloat.java","0","0","0","0","0"
"3","VarPopInt.java","0","0","0","0","0"
"3","VarPopLong.java","0","0","0","0","0"
"3","VarSamp.java","0","0","0","0","0"
"3","VarSampDouble.java","0","0","0","0","0"
"3","VarSampFloat.java","0","0","0","0","0"
"3","VarSampInt.java","0","0","0","0","0"
"3","VarSampLong.java","0","0","0","0","0"
"3","AddDays.java","0","0","0","0","0"
"3","AddMonths.java","0","0","0","0","0"
"3","CurrentDate.java","47420","138991","186411","47420","15806.0"
"3","CurrentTime.java","0","0","0","0","0"
"3","DatePartFromDate.java","136406","358031","494437","136406","45468.0"
"3","DatePartFromTime.java","132189","273928","406117","132189","44063.0"
"3","DatePartFromTimestamp.java","132189","273928","406117","132189","44063.0"
"3","DateTimePartFromUnixTimestamp.java","127005","244726","371731","127005","42335.0"
"3","NowTimestamp.java","0","0","0","0","0"
"3","ToCharTimestamp.java","122585","283195","405780","127866","42622.0"
"3","ToDate.java","84600","225198","309798","84600","28200.0"
"3","ToTimestampInt.java","0","0","0","0","0"
"3","ToTimestampText.java","47149","141430","188579","47149","15716.0"
"3","FailFunction.java","0","0","0","0","0"
"3","FunctionLoader.java","92487","142115","234602","92487","30829.0"
"3","BlobToIPstr.java","0","0","0","0","0"
"3","GeoIPCountryBlob.java","0","0","0","0","0"
"3","GeoIPCountryInt.java","0","0","0","0","0"
"3","GeoIPCountryText.java","0","0","0","0","0"
"3","GeoIPInCountryBlob.java","0","0","0","0","0"
"3","GeoIPInCountryInt.java","0","0","0","0","0"
"3","GeoIPInCountryText.java","144213","354057","498270","144213","48071.0"
"3","IntToIPstr.java","0","0","0","0","0"
"3","IPstrToBlob.java","0","0","0","0","0"
"3","IPstrToInt.java","0","0","0","0","0"
"3","HiveFunctionLoader.java","0","0","0","0","0"
"3","JsonArrayContains.java","0","0","0","0","0"
"3","JsonArrayGet.java","0","0","0","0","0"
"3","JsonArrayLength.java","0","0","0","0","0"
"3","JsonExtractPathText.java","0","0","0","0","0"
"3","ScalarJsonFunction.java","0","0","0","0","0"
"3","AbsDouble.java","0","0","0","0","0"
"3","AbsFloat.java","0","0","0","0","0"
"3","AbsInt.java","0","0","0","0","0"
"3","AbsLong.java","0","0","0","0","0"
"3","Acos.java","0","0","0","0","0"
"3","Asin.java","0","0","0","0","0"
"3","Atan.java","0","0","0","0","0"
"3","Atan2.java","0","0","0","0","0"
"3","Cbrt.java","0","0","0","0","0"
"3","Ceil.java","0","0","0","0","0"
"3","Cos.java","0","0","0","0","0"
"3","Degrees.java","0","0","0","0","0"
"3","Div.java","122913","366311","489224","122913","40971.0"
"3","Exp.java","0","0","0","0","0"
"3","Floor.java","0","0","0","0","0"
"3","MathFunctions.java","0","0","0","0","0"
"3","Mod.java","122913","366311","489224","122913","40971.0"
"3","Pi.java","0","0","0","0","0"
"3","Pow.java","0","0","0","0","0"
"3","Radians.java","0","0","0","0","0"
"3","Round.java","0","0","0","0","0"
"3","RoundFloat8.java","93291","277705","370996","93291","31097.0"
"3","Sign.java","0","0","0","0","0"
"3","Sin.java","0","0","0","0","0"
"3","Sqrt.java","0","0","0","0","0"
"3","Tan.java","0","0","0","0","0"
"3","Ascii.java","122457","366311","488768","122457","40819.0"
"3","BitLength.java","118277","366469","484746","118277","39425.0"
"3","BTrim.java","100367","272785","373152","100367","33455.0"
"3","CharLength.java","113915","369562","483477","113915","37971.0"
"3","Chr.java","125108","366188","491296","125108","41702.0"
"3","Concat.java","149520","349931","499451","149520","49840.0"
"3","Concat_ws.java","149609","349931","499540","149609","49869.0"
"3","Decode.java","130820","365207","496027","130820","43606.0"
"3","Digest.java","134921","358041","492962","134921","44973.0"
"3","Encode.java","130820","365207","496027","130820","43606.0"
"3","FindInSet.java","130842","364340","495182","130842","43614.0"
"3","HexStringConverter.java","0","0","0","0","0"
"3","InitCap.java","121911","366311","488222","121911","40637.0"
"3","Left.java","119990","366462","486452","119990","39996.0"
"3","Length.java","0","0","0","0","0"
"3","Locate.java","123701","366301","490002","123701","41233.0"
"3","Lower.java","0","0","0","0","0"
"3","Lpad.java","119482","267061","386543","119482","39827.0"
"3","LTrim.java","100367","272785","373152","100367","33455.0"
"3","Md5.java","118960","366467","485427","118960","39653.0"
"3","OctetLength.java","0","0","0","0","0"
"3","QuoteIdent.java","0","0","0","0","0"
"3","RegexpReplace.java","92073","291843","383916","92073","30691.0"
"3","Repeat.java","120224","366462","486686","120224","40074.0"
"3","Reverse.java","118885","366467","485352","118885","39628.0"
"3","Right.java","119990","366462","486452","119990","39996.0"
"3","Rpad.java","119576","267061","386637","119576","39858.0"
"3","RTrim.java","100367","272785","373152","100367","33455.0"
"3","SplitPart.java","92866","373201","466067","92866","30955.0"
"3","StrPos.java","118818","366467","485285","118818","39606.0"
"3","StrPosb.java","118818","366467","485285","118818","39606.0"
"3","Substr.java","118214","366469","484683","118214","39404.0"
"3","ToBin.java","0","0","0","0","0"
"3","ToCharLong.java","0","0","0","0","0"
"3","ToHex.java","0","0","0","0","0"
"3","Upper.java","101185","370152","471337","101185","33728.0"
"3","FirstValue.java","49946","118111","168057","49946","16648.0"
"3","FirstValueDate.java","0","0","0","0","0"
"3","FirstValueDouble.java","0","0","0","0","0"
"3","FirstValueFloat.java","0","0","0","0","0"
"3","FirstValueInt.java","0","0","0","0","0"
"3","FirstValueLong.java","0","0","0","0","0"
"3","FirstValueString.java","0","0","0","0","0"
"3","FirstValueTime.java","0","0","0","0","0"
"3","FirstValueTimestamp.java","0","0","0","0","0"
"3","Lag.java","34400","96788","131188","34400","11466.0"
"3","LagDate.java","0","0","0","0","0"
"3","LagDouble.java","0","0","0","0","0"
"3","LagFloat.java","0","0","0","0","0"
"3","LagInt.java","0","0","0","0","0"
"3","LagLong.java","0","0","0","0","0"
"3","LagString.java","0","0","0","0","0"
"3","LagTime.java","0","0","0","0","0"
"3","LagTimestamp.java","0","0","0","0","0"
"3","Rank.java","0","0","0","0","0"
"3","RowNumber.java","0","0","0","0","0"
"3","CoreGsonHelper.java","74191","277263","351454","74191","24730.0"
"3","Enforcer.java","92265","375743","468008","112800","37600.0"
"3","DistinctGroupbyBuilder.java","72201","187836","260037","72201","24067.0"
"3","DataChannel.java","90841","275983","366824","90841","30280.0"
"3","ExecutionBlock.java","83580","375555","459135","126082","42027.0"
"3","ExecutionBlockCursor.java","82697","314176","396873","90186","30062.0"
"3","ExecutionQueue.java","0","0","0","0","0"
"3","GlobalPlanner.java","82572","278819","361391","129211","43070.0"
"3","MasterPlan.java","92072","372942","465014","123816","41272.0"
"3","ParallelExecutionQueue.java","127186","171988","299174","127186","42395.0"
"3","BaseGlobalPlanRewriteRuleProvider.java","47050","111962","159012","47050","15683.0"
"3","GlobalPlanRewriteEngine.java","110986","221786","332772","110986","36995.0"
"3","GlobalPlanRewriteRule.java","0","0","0","0","0"
"3","GlobalPlanRewriteRuleProvider.java","0","0","0","0","0"
"3","GlobalPlanTestRuleProvider.java","0","0","0","0","0"
"3","BroadcastJoinRule.java","116525","133066","249591","116525","38841.0"
"3","GlobalPlanEqualityTester.java","0","0","0","0","0"
"3","GlobalPlanRewriteUtil.java","0","0","0","0","0"
"3","KeyProjector.java","0","0","0","0","0"
"3","AggregationExec.java","134828","302594","437422","134828","44942.0"
"3","BasicPhysicalExecutorVisitor.java","92755","391124","483879","92755","30918.0"
"3","BinaryPhysicalExec.java","0","0","0","0","0"
"3","BSTIndexScanExec.java","83604","321848","405452","83604","27868.0"
"3","ColPartitionStoreExec.java","131779","283921","415700","131779","43926.0"
"3","CommonHashJoinExec.java","31147","77687","108834","31147","10382.0"
"3","CommonJoinExec.java","10213","23123","33336","10213","3404.0"
"3","ComparableVector.java","1299","6754","8053","1299","433.0"
"3","DistinctGroupbyFirstAggregationExec.java","72906","104182","177088","72906","24302.0"
"3","DistinctGroupbyHashAggregationExec.java","39295","124114","163409","39295","13098.0"
"3","DistinctGroupbySecondAggregationExec.java","111591","213498","325089","111591","37197.0"
"3","DistinctGroupbySortAggregationExec.java","73298","191626","264924","73298","24432.0"
"3","DistinctGroupbyThirdAggregationExec.java","84390","120082","204472","84390","28130.0"
"3","EmptyScanIterator.java","0","0","0","0","0"
"3","EvalExprExec.java","83614","332037","415651","113432","37810.0"
"3","ExternalSortExec.java","119497","248116","367613","119497","39832.0"
"3","FilterScanIterator.java","0","0","0","0","0"
"3","FullScanIterator.java","0","0","0","0","0"
"3","HashAggregateExec.java","83983","381677","465660","128475","42825.0"
"3","HashBasedColPartitionStoreExec.java","137127","363311","500438","137127","45709.0"
"3","HashFullOuterJoinExec.java","97507","331556","429063","129292","43097.0"
"3","HashJoinExec.java","83580","334734","418314","83580","27860.0"
"3","HashLeftAntiJoinExec.java","79733","332674","412407","79733","26577.0"
"3","HashLeftOuterJoinExec.java","96620","313018","409638","96620","32206.0"
"3","HashLeftSemiJoinExec.java","80054","332674","412728","100645","33548.0"
"3","HashPartitioner.java","0","0","0","0","0"
"3","HashShuffleFileWriteExec.java","82600","306204","388804","124406","41468.0"
"3","HavingExec.java","132757","303075","435832","132757","44252.0"
"3","IndexExecutorUtil.java","0","0","0","0","0"
"3","InsertRowsExec.java","0","0","0","0","0"
"3","JoinTupleComparator.java","0","0","0","0","0"
"3","KeyTuple.java","2685","2841","5526","2685","895.0"
"3","LimitExec.java","0","0","0","0","0"
"3","MergeFullOuterJoinExec.java","97511","318650","416161","97511","32503.0"
"3","MergeJoinExec.java","83604","321848","405452","83604","27868.0"
"3","Partitioner.java","0","0","0","0","0"
"3","PartitionMergeScanExec.java","134720","294113","428833","134720","44906.0"
"3","PhysicalExec.java","0","0","0","0","0"
"3","PhysicalExecutorVisitor.java","0","0","0","0","0"
"3","PhysicalPlanUtil.java","34961","90298","125259","127786","42595.0"
"3","ProjectionExec.java","0","0","0","0","0"
"3","RadixSort.java","0","0","0","0","0"
"3","RangeShuffleFileWriteExec.java","82577","284823","367400","82577","27525.0"
"3","RightOuterMergeJoinExec.java","97507","331556","429063","110815","36938.0"
"3","ScanExec.java","0","0","0","0","0"
"3","ScanIterator.java","0","0","0","0","0"
"3","SelectionExec.java","83604","321848","405452","83604","27868.0"
"3","SeqScanExec.java","82592","293945","376537","126804","42268.0"
"3","SetTupleComparator.java","0","0","0","0","0"
"3","SortAggregateExec.java","83983","381677","465660","128475","42825.0"
"3","SortBasedColPartitionStoreExec.java","137127","363311","500438","137127","45709.0"
"3","SortExec.java","83603","320421","404024","83603","27867.0"
"3","SortIntersectExec.java","0","0","0","0","0"
"3","StoreIndexExec.java","99780","108724","208504","99780","33260.0"
"3","StoreTableExec.java","82600","306204","388804","124407","41469.0"
"3","TunnelExec.java","0","0","0","0","0"
"3","TupleList.java","0","0","0","0","0"
"3","TupleMap.java","0","0","0","0","0"
"3","TupleSet.java","0","0","0","0","0"
"3","TupleSorter.java","2320","3992","6312","2320","773.0"
"3","UnaryPhysicalExec.java","0","0","0","0","0"
"3","UnionExec.java","0","0","0","0","0"
"3","VectorizedSorter.java","2320","3992","6312","2320","773.0"
"3","WindowAggExec.java","35808","106404","142212","35808","11936.0"
"3","PhysicalPlanner.java","0","0","0","0","0"
"3","PhysicalPlannerImpl.java","82600","306204","388804","128893","42964.0"
"3","PhysicalPlanningException.java","0","0","0","0","0"
"3","Projector.java","82572","278819","361391","127846","42615.0"
"3","RangePartitionAlgorithm.java","83566","375934","459500","127783","42594.0"
"3","UniformRangePartition.java","83566","375934","459500","117218","39072.0"
"3","QueryContext.java","80596","276325","356921","126940","42313.0"
"3","TaskRequest.java","0","0","0","0","0"
"3","TaskRequestImpl.java","82703","306590","389293","90839","30279.0"
"3","CacheHolder.java","15320","32971","48291","15320","5106.0"
"3","TableCache.java","0","0","0","0","0"
"3","TableCacheKey.java","148834","282336","431170","148834","49611.0"
"3","ErrorInjectionRewriter.java","0","0","0","0","0"
"3","TupleUtil.java","82600","306204","388804","114383","38127.0"
"3","HdfsServiceTracker.java","5381","8241","13622","5381","1793.0"
"3","AsyncTaskService.java","0","0","0","0","0"
"3","WorkerConnectionInfo.java","0","0","0","0","0"
"3","FragmentScheduleEvent.java","125821","287403","413224","125821","41940.0"
"3","LocalTaskEvent.java","140321","359411","499732","140321","46773.0"
"3","LocalTaskEventType.java","0","0","0","0","0"
"3","QueryCompletedEvent.java","0","0","0","0","0"
"3","QueryDiagnosticsUpdateEvent.java","0","0","0","0","0"
"3","QueryEvent.java","0","0","0","0","0"
"3","QueryEventType.java","0","0","0","0","0"
"3","QueryMasterQueryCompletedEvent.java","0","0","0","0","0"
"3","QueryStartEvent.java","147482","353416","500898","147482","49160.0"
"3","QueryStopEvent.java","108386","212992","321378","108386","36128.0"
"3","StageCompletedEvent.java","82703","307090","389793","82703","27567.0"
"3","StageDiagnosticsUpdateEvent.java","120736","295584","416320","120736","40245.0"
"3","StageEvent.java","82703","307090","389793","82703","27567.0"
"3","StageEventType.java","82704","312487","395191","82704","27568.0"
"3","StageShuffleReportEvent.java","0","0","0","0","0"
"3","StageTaskEvent.java","0","0","0","0","0"
"3","StageTaskFailedEvent.java","0","0","0","0","0"
"3","TaskAttemptAssignedEvent.java","0","0","0","0","0"
"3","TaskAttemptEvent.java","0","0","0","0","0"
"3","TaskAttemptEventType.java","0","0","0","0","0"
"3","TaskAttemptScheduleEvent.java","0","0","0","0","0"
"3","TaskAttemptStatusUpdateEvent.java","0","0","0","0","0"
"3","TaskAttemptToSchedulerEvent.java","0","0","0","0","0"
"3","TaskCompletionEvent.java","0","0","0","0","0"
"3","TaskEvent.java","0","0","0","0","0"
"3","TaskEventType.java","0","0","0","0","0"
"3","TaskFatalErrorEvent.java","0","0","0","0","0"
"3","TaskRequestEvent.java","0","0","0","0","0"
"3","TaskSchedulerEvent.java","0","0","0","0","0"
"3","TaskTAttemptEvent.java","82703","306590","389293","82703","27567.0"
"3","TaskTAttemptFailedEvent.java","0","0","0","0","0"
"3","CreateTableExecutor.java","3861","7590","11451","3861","1287.0"
"3","DDLExecutor.java","31951","46704","78655","31951","10650.0"
"3","ExplainGlobalPlanPreprocessorForTest.java","0","0","0","0","0"
"3","ExplainPlanPreprocessorForTest.java","20936","71145","92081","20936","6978.0"
"3","NonForwardQueryResultFileScanner.java","29489","43630","73119","29489","9829.0"
"3","NonForwardQueryResultScanner.java","73047","111147","184194","73047","24349.0"
"3","NonForwardQueryResultSystemScanner.java","21579","23334","44913","21579","7193.0"
"3","CreateTableHook.java","54138","126057","180195","54138","18046.0"
"3","DistributedQueryHook.java","0","0","0","0","0"
"3","DistributedQueryHookManager.java","0","0","0","0","0"
"3","InsertIntoHook.java","0","0","0","0","0"
"3","QueryExecutor.java","5093","10576","15669","5093","1697.0"
"3","GlobalEngine.java","85250","220715","305965","120441","40147.0"
"3","QueryCoordinatorService.java","79969","310379","390348","79969","26656.0"
"3","QueryInfo.java","79761","287678","367439","110688","36896.0"
"3","QueryInProgress.java","79968","310313","390281","114509","38169.0"
"3","QueryManager.java","79777","290506","370283","111690","37230.0"
"3","NodeEvent.java","142109","358708","500817","142109","47369.0"
"3","NodeEventType.java","0","0","0","0","0"
"3","NodeLivelinessMonitor.java","142109","358708","500817","142109","47369.0"
"3","NodeReconnectEvent.java","142109","358708","500817","142109","47369.0"
"3","NodeState.java","142109","358708","500817","142109","47369.0"
"3","NodeStatus.java","0","0","0","0","0"
"3","NodeStatusEvent.java","0","0","0","0","0"
"3","TajoResourceManager.java","0","0","0","0","0"
"3","TajoResourceTracker.java","140329","306888","447217","140329","46776.0"
"3","TajoRMContext.java","142109","358708","500817","142109","47369.0"
"3","WorkerResource.java","80949","373896","454845","80949","26983.0"
"3","FileSystemRule.java","0","0","0","0","0"
"3","MasterRuleProvider.java","0","0","0","0","0"
"3","AbstractQueryScheduler.java","0","0","0","0","0"
"3","ResourceReserveSchedulerEvent.java","0","0","0","0","0"
"3","SchedulerEvent.java","0","0","0","0","0"
"3","SchedulerEventType.java","0","0","0","0","0"
"3","QuerySchedulingInfo.java","99110","282161","381271","99110","33036.0"
"3","QueueInfo.java","0","0","0","0","0"
"3","QueueState.java","0","0","0","0","0"
"3","Scheduler.java","0","0","0","0","0"
"3","SchedulingAlgorithms.java","99110","282161","381271","99110","33036.0"
"3","SimpleScheduler.java","0","0","0","0","0"
"3","TajoResourceScheduler.java","0","0","0","0","0"
"3","TajoMaster.java","82577","289799","372376","126481","42160.0"
"3","TajoMasterClientService.java","82577","289799","372376","128810","42936.0"
"3","TaskState.java","0","0","0","0","0"
"3","ClusterResourceMetricSet.java","0","0","0","0","0"
"3","SQLAnalyzer.java","75712","294787","370499","129019","43006.0"
"3","SQLErrorListener.java","76524","396039","472563","76524","25508.0"
"3","SQLParseError.java","76524","396039","472563","76524","25508.0"
"3","AbstractTaskScheduler.java","83572","378498","462070","83572","27857.0"
"3","DefaultTaskScheduler.java","82600","306204","388804","129813","43271.0"
"3","FetchScheduleEvent.java","0","0","0","0","0"
"3","Query.java","82577","289799","372376","128844","42948.0"
"3","QueryJobEvent.java","0","0","0","0","0"
"3","QueryMaster.java","76167","288252","364419","120627","40209.0"
"3","QueryMasterManagerService.java","114754","327621","442375","124696","41565.0"
"3","QueryMasterTask.java","79783","304082","383865","126740","42246.0"
"3","Repartitioner.java","82572","278819","361391","124636","41545.0"
"3","Stage.java","3696","8935","12631","3696","1232.0"
"3","StageState.java","0","0","0","0","0"
"3","Task.java","82577","289799","372376","129883","43294.0"
"3","TaskAttempt.java","82703","306590","389293","122287","40762.0"
"3","TaskSchedulerContext.java","0","0","0","0","0"
"3","TaskSchedulerFactory.java","0","0","0","0","0"
"3","DefaultResourceCalculator.java","0","0","0","0","0"
"3","NodeResource.java","0","0","0","0","0"
"3","NodeResources.java","0","0","0","0","0"
"3","ResourceCalculator.java","0","0","0","0","0"
"3","NoSuchSessionVariableException.java","83983","380705","464688","83983","27994.0"
"3","Session.java","145048","301041","446089","145048","48349.0"
"3","SessionConstants.java","0","0","0","0","0"
"3","SessionEvent.java","0","0","0","0","0"
"3","SessionEventType.java","0","0","0","0","0"
"3","SessionLivelinessMonitor.java","0","0","0","0","0"
"3","SessionManager.java","148438","356386","504824","148438","49479.0"
"3","ApplicationIdUtils.java","0","0","0","0","0"
"3","GeoIPUtil.java","0","0","0","0","0"
"3","History.java","0","0","0","0","0"
"3","HistoryCleaner.java","0","0","0","0","0"
"3","HistoryReader.java","36471","53136","89607","36471","12157.0"
"3","HistoryWriter.java","39364","56529","95893","39364","13121.0"
"3","QueryHistory.java","39364","56529","95893","39364","13121.0"
"3","StageHistory.java","36471","53136","89607","36471","12157.0"
"3","TaskHistory.java","44161","131268","175429","122004","40668.0"
"3","IPconvertUtil.java","0","0","0","0","0"
"3","JSPUtil.java","91659","286616","378275","113788","37929.0"
"3","JvmPauseMonitor.java","0","0","0","0","0"
"3","GroupNameMetricsFilter.java","0","0","0","0","0"
"3","LogEventGaugeSet.java","0","0","0","0","0"
"3","MetricsFilterList.java","0","0","0","0","0"
"3","RegexpMetricsFilter.java","0","0","0","0","0"
"3","GangliaReporter.java","0","0","0","0","0"
"3","MetricsConsoleReporter.java","0","0","0","0","0"
"3","MetricsConsoleScheduledReporter.java","0","0","0","0","0"
"3","MetricsFileScheduledReporter.java","0","0","0","0","0"
"3","MetricsStreamScheduledReporter.java","0","0","0","0","0"
"3","NullReporter.java","0","0","0","0","0"
"3","TajoMetricsReporter.java","129232","370379","499611","129232","43077.0"
"3","TajoMetricsScheduledReporter.java","0","0","0","0","0"
"3","TajoJMXObjectNameFactory.java","0","0","0","0","0"
"3","TajoLogEventCounter.java","0","0","0","0","0"
"3","TajoMetrics.java","129236","370559","499795","129236","43078.0"
"3","TajoSystemMetrics.java","129236","370559","499795","129236","43078.0"
"3","RpcParameterFactory.java","0","0","0","0","0"
"3","SplitUtil.java","0","0","0","0","0"
"3","TajoUncaughtExceptionHandler.java","0","0","0","0","0"
"3","TimeZoneUtil.java","0","0","0","0","0"
"3","HttpServer.java","84547","417220","501767","84547","28182.0"
"3","QueryExecutorServlet.java","112819","279971","392790","118903","39634.0"
"3","StaticHttpServer.java","82697","314176","396873","82697","27565.0"
"3","AbstractFetcher.java","0","0","0","0","0"
"3","DeletionService.java","0","0","0","0","0"
"3","ExecutionBlockErrorEvent.java","108386","212992","321378","108386","36128.0"
"3","ExecutionBlockStopEvent.java","7998","13700","21698","7998","2666.0"
"3","NodeResourceAllocateEvent.java","24071","29501","53572","24071","8023.0"
"3","NodeResourceDeallocateEvent.java","24071","29501","53572","24071","8023.0"
"3","NodeResourceEvent.java","18376","18104","36480","18376","6125.0"
"3","NodeStatusEvent.java","0","0","0","0","0"
"3","QMResourceAllocateEvent.java","0","0","0","0","0"
"3","QueryStopEvent.java","108386","212992","321378","108386","36128.0"
"3","TaskManagerEvent.java","0","0","0","0","0"
"3","TaskStartEvent.java","18376","18104","36480","18376","6125.0"
"3","ExecutionBlockContext.java","69324","102891","172215","69324","23108.0"
"3","ExecutionBlockSharedResource.java","34831","41979","76810","34831","11610.0"
"3","FetchImpl.java","39173","130791","169964","39173","13057.0"
"3","LocalFetcher.java","0","0","0","0","0"
"3","NodeResourceManager.java","7998","13700","21698","7998","2666.0"
"3","NodeStatusUpdater.java","7998","13700","21698","7998","2666.0"
"3","RemoteFetcher.java","82775","314577","397352","124406","41468.0"
"3","ConnectivityCheckerRuleForTajoWorker.java","12","123","135","12","4.0"
"3","WorkerRuleProvider.java","0","0","0","0","0"
"3","TajoQueryEngine.java","0","0","0","0","0"
"3","TajoWorker.java","79761","287678","367439","124765","41588.0"
"3","TajoWorkerClientService.java","76167","288252","364419","112173","37391.0"
"3","TajoWorkerManagerService.java","80948","376569","457517","119948","39982.0"
"3","Task.java","82577","289799","372376","129883","43294.0"
"3","TaskAttemptContext.java","82709","310829","393538","124467","41489.0"
"3","TaskContainer.java","0","0","0","0","0"
"3","TaskExecutor.java","18376","18104","36480","18376","6125.0"
"3","TaskHistory.java","44161","131268","175429","122004","40668.0"
"3","TaskImpl.java","18376","18104","36480","18376","6125.0"
"3","TaskManager.java","18376","18104","36480","18376","6125.0"
"3","RestReturnType.java","0","0","0","0","0"
"3","ClientApplication.java","10959","18318","29277","10959","3653.0"
"3","JerseyResourceDelegate.java","0","0","0","0","0"
"3","JerseyResourceDelegateContext.java","0","0","0","0","0"
"3","JerseyResourceDelegateContextKey.java","0","0","0","0","0"
"3","JerseyResourceDelegateUtil.java","0","0","0","0","0"
"3","NewDatabaseRequest.java","0","0","0","0","0"
"3","NewSessionRequest.java","0","0","0","0","0"
"3","SubmitQueryRequest.java","0","0","0","0","0"
"3","ClusterResource.java","35483","86544","122027","35483","11827.0"
"3","DatabasesResource.java","5770","11966","17736","5770","1923.0"
"3","FunctionsResource.java","24865","76158","101023","24865","8288.0"
"3","AbstractStreamingOutput.java","0","0","0","0","0"
"3","BinaryStreamingOutput.java","0","0","0","0","0"
"3","CSVStreamingOutput.java","0","0","0","0","0"
"3","RestOutputFactory.java","0","0","0","0","0"
"3","QueryResource.java","21796","69980","91776","21796","7265.0"
"3","QueryResultResource.java","27107","79829","106936","27107","9035.0"
"3","SessionsResource.java","0","0","0","0","0"
"3","TablesResource.java","27128","79851","106979","27128","9042.0"
"3","ResourcesUtil.java","0","0","0","0","0"
"3","DatabaseInfoResponse.java","0","0","0","0","0"
"3","ExceptionResponse.java","0","0","0","0","0"
"3","GetQueryResultDataResponse.java","0","0","0","0","0"
"3","GetSubmitQueryResponse.java","0","0","0","0","0"
"3","NewSessionResponse.java","0","0","0","0","0"
"3","ResultSetInfoResponse.java","0","0","0","0","0"
"3","WorkerConnectionInfoResponse.java","0","0","0","0","0"
"3","WorkerResponse.java","5770","11966","17736","5770","1923.0"
"3","TajoRestService.java","0","0","0","0","0"
"3","TestTPCH.java","83580","375555","459135","83580","27860.0"
"3","TestDDLBuilder.java","101626","409356","510982","101626","33875.0"
"3","TestTajoDump.java","151659","282708","434367","151659","50553.0"
"3","TestExecExternalShellCommand.java","0","0","0","0","0"
"3","TestHdfsCommand.java","0","0","0","0","0"
"3","TestDefaultCliOutputFormatter.java","43365","139141","182506","43365","14455.0"
"3","TestSimpleParser.java","146576","306227","452803","146576","48858.0"
"3","TestTajoCli.java","45297","150448","195745","45297","15099.0"
"3","TestTajoCliNegatives.java","109654","140944","250598","109654","36551.0"
"3","TestCatalogAdminClientExceptions.java","0","0","0","0","0"
"3","TestQueryClientExceptions.java","106912","116183","223095","106912","35637.0"
"3","TestTajoClient.java","131041","268510","399551","131041","43680.0"
"3","TestTajoClientV2.java","3446","5585","9031","3446","1148.0"
"3","TestWorkerConnectionInfo.java","0","0","0","0","0"
"3","TestEvalCodeGenerator.java","0","0","0","0","0"
"3","TestGeneratorAdapter.java","0","0","0","0","0"
"3","ExprTestBase.java","91597","292133","383730","127846","42615.0"
"3","TestEvalTree.java","83604","321848","405452","127786","42595.0"
"3","TestEvalTreeUtil.java","83614","332037","415651","129692","43230.0"
"3","TestIntervalType.java","47149","141430","188579","47149","15716.0"
"3","TestPredicates.java","0","0","0","0","0"
"3","TestSQLDateTimeTypes.java","0","0","0","0","0"
"3","TestSQLExpression.java","47149","141430","188579","125964","41988.0"
"3","HiveUDFtest.java","0","0","0","0","0"
"3","TestHiveFunctionLoader.java","0","0","0","0","0"
"3","TestHiveFunctions.java","0","0","0","0","0"
"3","NullTestFunction.java","0","0","0","0","0"
"3","TestAggFunction.java","0","0","0","0","0"
"3","TestBuiltinFunctions.java","82704","312460","395164","82704","27568.0"
"3","TestConditionalExpressions.java","0","0","0","0","0"
"3","TestDateTimeFunctions.java","47149","141430","188579","128837","42945.0"
"3","TestFunctionLoader.java","150215","295778","445993","150215","50071.0"
"3","TestGeneralFunction.java","0","0","0","0","0"
"3","TestJsonFunctions.java","46246","106952","153198","46246","15415.0"
"3","TestMathFunctions.java","119262","377557","496819","126418","42139.0"
"3","TestPatternMatchingPredicates.java","0","0","0","0","0"
"3","TestPythonFunctions.java","1668","4550","6218","1668","556.0"
"3","TestStringOperatorsAndFunctions.java","0","0","0","0","0"
"3","TestUserDefinedFunctions.java","0","0","0","0","0"
"3","TestMasterPlan.java","0","0","0","0","0"
"3","TestExternalSortExec.java","82600","306204","388804","82600","27533.0"
"3","TestFullOuterHashJoinExec.java","96260","275402","371662","116292","38764.0"
"3","TestFullOuterMergeJoinExec.java","96298","289270","385568","116292","38764.0"
"3","TestHashAntiJoinExec.java","79733","369078","448811","116292","38764.0"
"3","TestHashJoinExec.java","82600","306204","388804","116292","38764.0"
"3","TestHashPartitioner.java","83566","375934","459500","83566","27855.0"
"3","TestHashSemiJoinExec.java","78879","290422","369301","116292","38764.0"
"3","TestLeftOuterHashJoinExec.java","96304","302803","399107","116292","38764.0"
"3","TestMergeJoinExec.java","82572","278819","361391","116292","38764.0"
"3","TestPhysicalPlanner.java","82572","278819","361391","129292","43097.0"
"3","TestProgressExternalSortExec.java","147396","354519","501915","147396","49132.0"
"3","TestRadixSort.java","0","0","0","0","0"
"3","TestRightOuterHashJoinExec.java","96304","302803","399107","116292","38764.0"
"3","TestRightOuterMergeJoinExec.java","96260","275402","371662","116292","38764.0"
"3","TestSortExec.java","82600","306204","388804","82600","27533.0"
"3","TestSortIntersectExec.java","112995","131080","244075","112995","37665.0"
"3","TestTupleSorter.java","41314","102190","143504","41314","13771.0"
"3","TestUnSafeTuple.java","0","0","0","0","0"
"3","TestEvalNodeToExprConverter.java","0","0","0","0","0"
"3","TestJoinOrderAlgorithm.java","0","0","0","0","0"
"3","TestLogicalOptimizer.java","82572","278819","361391","116292","38764.0"
"3","TestLogicalPlan.java","93091","414659","507750","93091","31030.0"
"3","TestLogicalPlanner.java","82572","278819","361391","128684","42894.0"
"3","TestPlannerUtil.java","82572","278819","361391","121575","40525.0"
"3","TestQueryValidation.java","71557","99893","171450","71557","23852.0"
"3","TestUniformRangePartition.java","83566","375934","459500","117218","39072.0"
"3","TestAlterTable.java","148486","293626","442112","148486","49495.0"
"3","TestAlterTablespace.java","0","0","0","0","0"
"3","TestCaseByCases.java","0","0","0","0","0"
"3","TestCommonConditionReduce.java","0","0","0","0","0"
"3","TestCreateDatabase.java","0","0","0","0","0"
"3","TestCreateIndex.java","0","0","0","0","0"
"3","TestCreateTable.java","147333","354501","501834","147333","49111.0"
"3","TestCrossJoin.java","0","0","0","0","0"
"3","TestCTASQuery.java","127687","296394","424081","127687","42562.0"
"3","TestDropTable.java","0","0","0","0","0"
"3","TestGroupByQuery.java","68505","175853","244358","127965","42655.0"
"3","TestHBaseTable.java","21013","25417","46430","21013","7004.0"
"3","TestIndexScan.java","0","0","0","0","0"
"3","TestInnerJoinQuery.java","0","0","0","0","0"
"3","TestInnerJoinWithSubQuery.java","124473","150320","274793","124473","41491.0"
"3","TestInsertQuery.java","80801","291431","372232","128515","42838.0"
"3","TestInSubquery.java","0","0","0","0","0"
"3","TestJoinOnPartitionedTables.java","138212","351791","490003","138212","46070.0"
"3","TestJoinQuery.java","94875","258754","353629","124499","41499.0"
"3","TestJsonWithTimezone.java","0","0","0","0","0"
"3","TestMultipleJoinTypes.java","29163","38196","67359","29163","9721.0"
"3","TestNullValues.java","82704","313326","396030","116082","38694.0"
"3","TestOuterJoinQuery.java","8068","12633","20701","8068","2689.0"
"3","TestOuterJoinWithSubQuery.java","0","0","0","0","0"
"3","TestQueryOnSelfDescTable.java","1515","5833","7348","1515","505.0"
"3","TestSelectNestedRecord.java","39148","90524","129672","39148","13049.0"
"3","TestSelectQuery.java","82592","295074","377666","128262","42754.0"
"3","TestSetSessionQuery.java","130433","261567","392000","130433","43477.0"
"3","TestSimpleQuery.java","0","0","0","0","0"
"3","TestSortQuery.java","63467","158850","222317","127783","42594.0"
"3","TestTablePartitions.java","127038","265313","392351","128489","42829.0"
"3","TestTableSubQuery.java","0","0","0","0","0"
"3","TestTimezone.java","0","0","0","0","0"
"3","TestTruncateTable.java","72329","177897","250226","72329","24109.0"
"3","TestUnionQuery.java","132708","300794","433502","132708","44236.0"
"3","TestWindowQuery.java","69521","168073","237594","69521","23173.0"
"3","BenchmarkSort.java","0","0","0","0","0"
"3","TestTableCache.java","0","0","0","0","0"
"3","TestTupleUtil.java","83580","335453","419033","83580","27860.0"
"3","TestHAServiceHDFSImpl.java","42223","113600","155823","42223","14074.0"
"3","TestMasterRules.java","0","0","0","0","0"
"3","TestSimpleScheduler.java","0","0","0","0","0"
"3","TestExecutionBlockCursor.java","114721","373469","488190","119301","39767.0"
"3","TestNonForwardQueryResultSystemScanner.java","22815","25117","47932","22815","7605.0"
"3","TestQueryResult.java","0","0","0","0","0"
"3","TestRepartitioner.java","67595","157375","224970","82390","27463.0"
"3","TestSQLAnalyzer.java","77440","393686","471126","77440","25813.0"
"3","TestIntermediateEntry.java","0","0","0","0","0"
"3","TestKillQuery.java","72356","106622","178978","72356","24118.0"
"3","TestQueryProgress.java","84042","122362","206404","84042","28014.0"
"3","TestQueryState.java","31801","77988","109789","31801","10600.0"
"3","TestTaskStatusUpdate.java","143386","363075","506461","143386","47795.0"
"3","TestResources.java","0","0","0","0","0"
"3","TestFileFragment.java","0","0","0","0","0"
"3","TestQueryOnOrcFile.java","0","0","0","0","0"
"3","TestQueryIdFactory.java","82703","306590","389293","82703","27567.0"
"3","TestTajoIds.java","82703","306590","389293","82703","27567.0"
"3","TestHistoryWriterReader.java","36471","53136","89607","36471","12157.0"
"3","TestJMXTajoObjectNameFactory.java","0","0","0","0","0"
"3","TestMetricsFilter.java","0","0","0","0","0"
"3","TestSystemMetrics.java","129236","370559","499795","129236","43078.0"
"3","TestIPconvertUtil.java","0","0","0","0","0"
"3","TestJSPUtil.java","123948","251494","375442","123948","41316.0"
"3","TestRpcParamFactory.java","0","0","0","0","0"
"3","TestTimeZoneUtil.java","0","0","0","0","0"
"3","MockExecutionBlockContext.java","0","0","0","0","0"
"3","MockNodeResourceManager.java","18376","18104","36480","18376","6125.0"
"3","MockNodeStatusUpdater.java","24071","29501","53572","24071","8023.0"
"3","MockTaskExecutor.java","18376","18104","36480","18376","6125.0"
"3","MockTaskManager.java","18376","18104","36480","18376","6125.0"
"3","MockWorkerContext.java","0","0","0","0","0"
"3","TestDeletionService.java","0","0","0","0","0"
"3","TestFetcherWithTajoPullServer.java","0","0","0","0","0"
"3","TestNodeResourceManager.java","7998","13700","21698","7998","2666.0"
"3","TestNodeStatusUpdater.java","7998","13700","21698","7998","2666.0"
"3","TestTaskExecutor.java","18376","18104","36480","18376","6125.0"
"3","TestTaskManager.java","18376","18104","36480","18376","6125.0"
"3","TestClusterResource.java","0","0","0","0","0"
"3","TestDatabasesResource.java","0","0","0","0","0"
"3","TestFunctionsResource.java","24865","76158","101023","24865","8288.0"
"3","TestQueryResource.java","21796","69980","91776","21796","7265.0"
"3","TestQueryResultResource.java","21796","69980","91776","21796","7265.0"
"3","TestSessionsResource.java","0","0","0","0","0"
"3","TestTablesResource.java","27128","79851","106979","27128","9042.0"
"3","JdbcConnection.java","124390","232474","356864","124390","41463.0"
"3","TajoDatabaseMetaData.java","114853","270136","384989","121159","40386.0"
"3","TajoDriver.java","0","0","0","0","0"
"3","TajoPreparedStatement.java","117707","314502","432209","117707","39235.0"
"3","TajoStatement.java","114853","270136","384989","115246","38415.0"
"3","QueryStringDecoder.java","0","0","0","0","0"
"3","TestResultSet.java","82704","313326","396030","113894","37964.0"
"3","TestSQLState.java","0","0","0","0","0"
"3","TestTajoDatabaseMetaData.java","154682","299636","454318","154682","51560.0"
"3","TestTajoJdbc.java","114960","283723","398683","120922","40307.0"
"3","TestTajoJdbcNegative.java","6339","9293","15632","6339","2113.0"
"3","TestQueryStringDecoder.java","0","0","0","0","0"
"3","TestResultSetUtil.java","0","0","0","0","0"
"3","ProtocMojo.java","0","0","0","0","0"
"3","Exec.java","0","0","0","0","0"
"3","FileSetUtils.java","0","0","0","0","0"
"3","VersionInfoMojo.java","0","0","0","0","0"
"3","MetricsUtil.java","0","0","0","0","0"
"3","TestMetricsUtil.java","0","0","0","0","0"
"3","AlgebraVisitor.java","77524","380379","457903","77524","25841.0"
"3","BaseAlgebraVisitor.java","76134","294790","370924","127179","42393.0"
"3","Prioritized.java","0","0","0","0","0"
"3","AggregationFunctionCallEval.java","82701","309764","392465","82701","27567.0"
"3","AlgebraicException.java","0","0","0","0","0"
"3","AlgebraicUtil.java","83594","319885","403479","126168","42056.0"
"3","BasicEvalNodeVisitor.java","93007","387224","480231","121578","40526.0"
"3","BetweenPredicateEval.java","114248","313414","427662","129232","43077.0"
"3","BinaryEval.java","83604","321848","405452","126654","42218.0"
"3","CaseWhenEval.java","83594","319885","403479","129232","43077.0"
"3","CastEval.java","91952","291849","383801","91952","30650.0"
"3","ConstEval.java","83604","321848","405452","129232","43077.0"
"3","EvalContext.java","1668","4550","6218","1668","556.0"
"3","EvalNode.java","82701","309764","392465","91016","30338.0"
"3","EvalNodeVisitor.java","0","0","0","0","0"
"3","EvalNodeVisitor2.java","0","0","0","0","0"
"3","EvalTreeFactory.java","0","0","0","0","0"
"3","EvalTreeUtil.java","82572","278819","361391","127846","42615.0"
"3","EvalType.java","77737","389209","466946","91366","30455.0"
"3","FieldEval.java","83604","321848","405452","83604","27868.0"
"3","FunctionEval.java","83604","321848","405452","91822","30607.0"
"3","GeneralFunctionEval.java","82592","295074","377666","82592","27530.0"
"3","InEval.java","80748","317805","398553","80748","26916.0"
"3","InvalidEvalException.java","0","0","0","0","0"
"3","IsNullEval.java","83594","319885","403479","83594","27864.0"
"3","LikePredicateEval.java","0","0","0","0","0"
"3","NotEval.java","83604","321848","405452","83604","27868.0"
"3","PartialBinaryExpr.java","83604","321848","405452","83604","27868.0"
"3","PatternMatchPredicateEval.java","92807","319105","411912","129292","43097.0"
"3","RegexPredicateEval.java","92794","317139","409933","92794","30931.0"
"3","RowConstantEval.java","80738","333257","413995","80738","26912.0"
"3","SignedEval.java","123645","311898","435543","123645","41215.0"
"3","SimilarToPredicateEval.java","0","0","0","0","0"
"3","SimpleEvalNodeVisitor.java","100517","297002","397519","100517","33505.0"
"3","SubqueryEval.java","0","0","0","0","0"
"3","UnaryEval.java","84891","222523","307414","84891","28297.0"
"3","ValueSetEval.java","0","0","0","0","0"
"3","WindowFunctionEval.java","35808","106404","142212","35808","11936.0"
"3","ExprAnnotator.java","128255","256576","384831","128714","42904.0"
"3","ExprNormalizer.java","128255","256576","384831","128255","42751.0"
"3","EvalTreeOptimizationRule.java","34320","94440","128760","34320","11440.0"
"3","EvalTreeOptimizer.java","34320","94440","128760","34320","11440.0"
"3","ConstantFolding.java","86258","188375","274633","86258","28752.0"
"3","ConstantPropagation.java","34320","94440","128760","34320","11440.0"
"3","AggFunction.java","83622","334927","418549","83622","27874.0"
"3","AggFunctionInvoke.java","0","0","0","0","0"
"3","ClassBasedAggFunctionInvoke.java","0","0","0","0","0"
"3","ClassBasedScalarFunctionInvoke.java","1668","4550","6218","1668","556.0"
"3","FunctionContext.java","0","0","0","0","0"
"3","FunctionInvoke.java","83256","142984","226240","83256","27752.0"
"3","FunctionInvokeContext.java","1668","4550","6218","1668","556.0"
"3","GeneralFunction.java","82592","295074","377666","82592","27530.0"
"3","HiveFunctionInvoke.java","0","0","0","0","0"
"3","PythonScriptEngine.java","1668","4550","6218","1668","556.0"
"3","TajoScriptEngine.java","1668","4550","6218","1668","556.0"
"3","PythonAggFunctionInvoke.java","0","0","0","0","0"
"3","PythonFunctionInvoke.java","0","0","0","0","0"
"3","BufferPool.java","66502","110968","177470","66502","22167.0"
"3","ByteBufInputChannel.java","0","0","0","0","0"
"3","ByteBufLineReader.java","4085","11290","15375","4085","1361.0"
"3","CSVLineDeserializer.java","57980","81059","139039","57980","19326.0"
"3","CSVLineSerDe.java","66186","103979","170165","66186","22062.0"
"3","CSVLineSerializer.java","57980","81059","139039","57980","19326.0"
"3","FieldSerializerDeserializer.java","66502","110968","177470","66502","22167.0"
"3","FieldSplitProcessor.java","0","0","0","0","0"
"3","InputHandler.java","0","0","0","0","0"
"3","LineSplitProcessor.java","0","0","0","0","0"
"3","OutputHandler.java","1668","4550","6218","1668","556.0"
"3","StreamingUtil.java","1668","4550","6218","1668","556.0"
"3","TextFieldSerializerDeserializer.java","1479","7317","8796","1479","493.0"
"3","TextLineDeserializer.java","66186","103979","170165","66186","22062.0"
"3","TextLineParsingError.java","0","0","0","0","0"
"3","TextLineSerDe.java","66186","103979","170165","66186","22062.0"
"3","TextLineSerializer.java","1668","4550","6218","1668","556.0"
"3","WindowAggFunc.java","0","0","0","0","0"
"3","Edge.java","0","0","0","0","0"
"3","FoundJoinOrder.java","0","0","0","0","0"
"3","GreedyHeuristicJoinOrderAlgorithm.java","113871","306954","420825","126050","42016.0"
"3","JoinEdge.java","100877","377154","478031","100877","33625.0"
"3","JoinedRelationsVertex.java","0","0","0","0","0"
"3","JoinGraph.java","100877","377154","478031","100877","33625.0"
"3","JoinGraphContext.java","18640","16847","35487","18640","6213.0"
"3","JoinOrderAlgorithm.java","113608","272228","385836","113608","37869.0"
"3","JoinOrderingUtil.java","22597","29806","52403","22597","7532.0"
"3","JoinVertex.java","0","0","0","0","0"
"3","RelationVertex.java","0","0","0","0","0"
"3","AlterTableNode.java","144736","277945","422681","144736","48245.0"
"3","AlterTablespaceNode.java","149801","276116","425917","149801","49933.0"
"3","BinaryNode.java","0","0","0","0","0"
"3","CreateDatabaseNode.java","141361","279432","420793","141361","47120.0"
"3","CreateIndexNode.java","0","0","0","0","0"
"3","CreateTableNode.java","82701","309764","392465","82701","27567.0"
"3","DistinctGroupbyNode.java","72201","187836","260037","72201","24067.0"
"3","DropDatabaseNode.java","141361","279432","420793","141361","47120.0"
"3","DropIndexNode.java","0","0","0","0","0"
"3","DropTableNode.java","75817","308829","384646","75817","25272.0"
"3","EvalExprNode.java","83594","319885","403479","83594","27864.0"
"3","ExceptNode.java","0","0","0","0","0"
"3","GroupbyNode.java","82701","309764","392465","128424","42808.0"
"3","GroupElement.java","0","0","0","0","0"
"3","HavingNode.java","132708","301073","433781","132708","44236.0"
"3","IndexScanNode.java","83594","319885","403479","83594","27864.0"
"3","InsertNode.java","80987","307446","388433","80987","26995.0"
"3","IntersectNode.java","0","0","0","0","0"
"3","JoinNode.java","83594","319885","403479","83594","27864.0"
"3","JoinSpec.java","0","0","0","0","0"
"3","LimitNode.java","82572","278819","361391","82572","27524.0"
"3","LogicalNode.java","82572","278819","361391","82572","27524.0"
"3","LogicalNodeVisitor.java","0","0","0","0","0"
"3","LogicalRootNode.java","0","0","0","0","0"
"3","NodeType.java","76092","308053","384145","76092","25364.0"
"3","PartitionedTableScanNode.java","127038","265313","392351","127038","42346.0"
"3","PersistentStoreNode.java","128902","303007","431909","128902","42967.0"
"3","Projectable.java","0","0","0","0","0"
"3","ProjectionNode.java","82701","309764","392465","82701","27567.0"
"3","RelationNode.java","92070","332718","424788","92070","30690.0"
"3","ScanNode.java","84545","415025","499570","126804","42268.0"
"3","SelectableNode.java","0","0","0","0","0"
"3","SelectionNode.java","83594","319885","403479","90651","30217.0"
"3","SetOperationNode.java","0","0","0","0","0"
"3","SetSessionNode.java","0","0","0","0","0"
"3","ShuffleFileWriteNode.java","128902","303007","431909","128902","42967.0"
"3","SortNode.java","83594","319885","403479","83594","27864.0"
"3","StoreTableNode.java","82572","278819","361391","82572","27524.0"
"3","TableSubQueryNode.java","93152","421129","514281","93152","31050.0"
"3","TruncateTableNode.java","72329","177897","250226","72329","24109.0"
"3","UnaryNode.java","0","0","0","0","0"
"3","UnionNode.java","0","0","0","0","0"
"3","WindowAggNode.java","134154","347585","481739","134154","44718.0"
"3","WindowSpec.java","69654","171066","240720","69654","23218.0"
"3","LogicalOptimizer.java","82572","278819","361391","127051","42350.0"
"3","LogicalPlan.java","75690","277886","353576","127857","42619.0"
"3","LogicalPlanner.java","82572","278819","361391","129216","43072.0"
"3","LogicalPlanPreprocessor.java","135500","380493","515993","135500","45166.0"
"3","NamedExprsManager.java","128255","256576","384831","128255","42751.0"
"3","NameResolver.java","89225","209410","298635","89225","29741.0"
"3","NameResolvingMode.java","0","0","0","0","0"
"3","ResolverByLegacy.java","35159","99838","134997","35159","11719.0"
"3","ResolverByRels.java","35159","99838","134997","35159","11719.0"
"3","ResolverByRelsAndSubExprs.java","35159","99838","134997","35159","11719.0"
"3","ResolverBySubExprsAndRels.java","35159","99838","134997","35159","11719.0"
"3","PlanString.java","93091","414659","507750","93091","31030.0"
"3","BaseLogicalPlanPreprocessEngine.java","0","0","0","0","0"
"3","BaseLogicalPlanPreprocessPhaseProvider.java","0","0","0","0","0"
"3","BaseLogicalPlanRewriteEngine.java","75872","277889","353761","75872","25290.0"
"3","BaseLogicalPlanRewriteRuleProvider.java","67172","146683","213855","67172","22390.0"
"3","BaseSchemaBuildPhase.java","2958","22080","25038","2958","986.0"
"3","LogicalPlanPreprocessEngine.java","0","0","0","0","0"
"3","LogicalPlanPreprocessPhase.java","0","0","0","0","0"
"3","LogicalPlanPreprocessPhaseProvider.java","0","0","0","0","0"
"3","LogicalPlanRewriteEngine.java","75999","308832","384831","75999","25333.0"
"3","LogicalPlanRewriteRule.java","75872","277889","353761","75872","25290.0"
"3","LogicalPlanRewriteRuleContext.java","115965","156612","272577","115965","38655.0"
"3","LogicalPlanRewriteRuleProvider.java","0","0","0","0","0"
"3","LogicalPlanTestRuleProvider.java","0","0","0","0","0"
"3","AccessPathInfo.java","0","0","0","0","0"
"3","AccessPathRewriter.java","0","0","0","0","0"
"3","CommonConditionReduceRule.java","95581","98270","193851","95581","31860.0"
"3","FilterPushDownRule.java","74568","277263","351831","126168","42056.0"
"3","IndexScanInfo.java","0","0","0","0","0"
"3","InSubqueryRewriteRule.java","0","0","0","0","0"
"3","LogicalPlanEqualityTester.java","65395","138862","204257","65395","21798.0"
"3","PartitionedTableRewriter.java","127038","265313","392351","127038","42346.0"
"3","ProjectionPushDownRule.java","74568","277263","351831","129135","43045.0"
"3","SeqScanInfo.java","0","0","0","0","0"
"3","SelfDescSchemaBuildPhase.java","1515","5833","7348","1515","505.0"
"3","TableStatUpdateRewriter.java","5027","8110","13137","5027","1675.0"
"3","EvalNodeAdapter.java","82572","278819","361391","82572","27524.0"
"3","EvalNodeDeserializer.java","73002","160863","233865","73002","24334.0"
"3","EvalNodeSerializer.java","73002","160863","233865","73002","24334.0"
"3","LogicalNodeAdapter.java","82572","278819","361391","82572","27524.0"
"3","LogicalNodeDeserializer.java","23033","29473","52506","23033","7677.0"
"3","LogicalNodeSerializer.java","23033","29473","52506","23033","7677.0"
"3","package-info.java","0","0","0","0","0"
"3","PlanGsonHelper.java","0","0","0","0","0"
"3","StorageService.java","123914","158234","282148","123914","41304.0"
"3","TablePropertyUtil.java","127059","169535","296594","127059","42353.0"
"3","Target.java","75690","277886","353576","75690","25230.0"
"3","TypeDeterminant.java","35808","106404","142212","35808","11936.0"
"3","EvalNodeToExprConverter.java","5892","9575","15467","5892","1964.0"
"3","ExprFinder.java","134808","364207","499015","134808","44936.0"
"3","PartitionFilterAlgebraVisitor.java","0","0","0","0","0"
"3","PlannerUtil.java","82572","278819","361391","127179","42393.0"
"3","WritableTypeConverter.java","0","0","0","0","0"
"3","ExprsVerifier.java","115067","415470","530537","127633","42544.0"
"3","LogicalPlanVerifier.java","111613","271209","382822","122077","40692.0"
"3","PostLogicalPlanVerifier.java","0","0","0","0","0"
"3","PreLogicalPlanVerifier.java","129240","255688","384928","129371","43123.0"
"3","SyntaxErrorException.java","114440","374153","488593","114440","38146.0"
"3","SyntaxErrorUtil.java","113147","127045","240192","113147","37715.0"
"3","VerificationState.java","114348","374419","488767","114348","38116.0"
"3","BasicLogicalPlanVisitor.java","74568","277263","351831","128079","42693.0"
"3","ExplainLogicalPlanVisitor.java","90841","275983","366824","127179","42393.0"
"3","LogicalPlanVisitor.java","74568","277263","351831","121205","40401.0"
"3","SimpleAlgebraVisitor.java","128255","256576","384831","128255","42751.0"
"3","TestExprAnnotator.java","0","0","0","0","0"
"3","TestLogicalNode.java","82572","278819","361391","82572","27524.0"
"3","TestWritableTypeConverter.java","0","0","0","0","0"
"3","FadvisedChunkedFile.java","84814","126137","210951","84814","28271.0"
"3","FadvisedFileRegion.java","84814","126137","210951","84814","28271.0"
"3","FileAccessForbiddenException.java","0","0","0","0","0"
"3","FileCloseListener.java","144714","284640","429354","144714","48238.0"
"3","HttpDataServerChannelInitializer.java","82775","314577","397352","82775","27591.0"
"3","HttpDataServerHandler.java","82775","314577","397352","82775","27591.0"
"3","HttpUtil.java","0","0","0","0","0"
"3","PullServerConstants.java","0","0","0","0","0"
"3","PullServerUtil.java","0","0","0","0","0"
"3","AdvancedDataRetriever.java","82703","306590","389293","82703","27567.0"
"3","DataRetriever.java","0","0","0","0","0"
"3","DirectoryRetriever.java","0","0","0","0","0"
"3","FileChunk.java","0","0","0","0","0"
"3","FileChunkMeta.java","0","0","0","0","0"
"3","IndexCacheKey.java","0","0","0","0","0"
"3","RetrieverHandler.java","0","0","0","0","0"
"3","TajoPullServer.java","0","0","0","0","0"
"3","TajoPullServerService.java","80046","312543","392589","124991","41663.0"
"3","NettyServerBase.java","82775","314577","397352","82775","27591.0"
"3","NettyUtils.java","6187","30766","36953","6187","2062.0"
"3","RemoteException.java","0","0","0","0","0"
"3","RetriesExhaustedException.java","0","0","0","0","0"
"3","RpcConstants.java","0","0","0","0","0"
"3","RpcEventListener.java","0","0","0","0","0"
"3","RpcUtils.java","11197","14951","26148","11197","3732.0"
"3","AsyncRpcClient.java","82775","314577","397352","82775","27591.0"
"3","AsyncRpcServer.java","82775","314577","397352","82775","27591.0"
"3","BlockingRpcClient.java","82775","314577","397352","127157","42385.0"
"3","BlockingRpcServer.java","82775","314577","397352","82775","27591.0"
"3","CallFuture.java","82775","314577","397352","82775","27591.0"
"3","CancelableRpcCallback.java","0","0","0","0","0"
"3","ChannelEventListener.java","4696","9687","14383","4696","1565.0"
"3","DefaultRpcController.java","111725","305662","417387","111725","37241.0"
"3","MonitorClientHandler.java","0","0","0","0","0"
"3","MonitorServerHandler.java","0","0","0","0","0"
"3","MonitorStateEvent.java","0","0","0","0","0"
"3","NettyClientBase.java","84432","125471","209903","84432","28144.0"
"3","NettyRpcController.java","0","0","0","0","0"
"3","NullCallback.java","83604","328510","412114","83604","27868.0"
"3","ProtoClientChannelInitializer.java","12183","30442","42625","12183","4061.0"
"3","ProtoDeclaration.java","0","0","0","0","0"
"3","ProtoServerChannelInitializer.java","0","0","0","0","0"
"3","RecoverableException.java","4696","9687","14383","4696","1565.0"
"3","RemoteCallException.java","82592","293945","376537","82592","27530.0"
"3","RpcClientManager.java","4696","9687","14383","4696","1565.0"
"3","RpcConnectionKey.java","0","0","0","0","0"
"3","TajoServiceException.java","0","0","0","0","0"
"3","DummyProtocolAsyncImpl.java","83622","333683","417305","83622","27874.0"
"3","DummyProtocolBlockingImpl.java","83622","333683","417305","83622","27874.0"
"3","TestAsyncRpc.java","82775","314577","397352","117416","39138.0"
"3","TestBlockingRpc.java","82775","314577","397352","117416","39138.0"
"3","TestRpcClientManager.java","4696","9687","14383","4696","1565.0"
"3","GsonFeature.java","3540","11523","15063","3540","1180.0"
"3","GsonReader.java","0","0","0","0","0"
"3","GsonUtil.java","0","0","0","0","0"
"3","GsonWriter.java","0","0","0","0","0"
"3","NettyRestChannelInitializer.java","0","0","0","0","0"
"3","NettyRestHandlerContainer.java","0","0","0","0","0"
"3","NettyRestHandlerContainerProvider.java","0","0","0","0","0"
"3","NettyRestServer.java","0","0","0","0","0"
"3","NettyRestServerFactory.java","0","0","0","0","0"
"3","NettyRestServerListener.java","0","0","0","0","0"
"3","ResourceConfigUtil.java","0","0","0","0","0"
"3","NettyRestHandlerContainerProviderTest.java","0","0","0","0","0"
"3","NettyRestServerTest.java","0","0","0","0","0"
"3","TestApplication1.java","0","0","0","0","0"
"3","TestResource1.java","0","0","0","0","0"
"3","DirectoriesDao.java","0","0","0","0","0"
"3","DirectoriesResource.java","0","0","0","0","0"
"3","Directory.java","0","0","0","0","0"
"3","FileManagementApplication.java","0","0","0","0","0"
"3","AbstractScanner.java","84967","154628","239595","84967","28322.0"
"3","ForSplitableStore.java","0","0","0","0","0"
"3","Appender.java","84573","423058","507631","84573","28191.0"
"3","BaseTupleComparator.java","126971","262752","389723","126971","42323.0"
"3","BinarySerializerDeserializer.java","117863","327845","445708","117863","39287.0"
"3","ByteBufInputChannel.java","0","0","0","0","0"
"3","CodecPool.java","0","0","0","0","0"
"3","DataLocation.java","0","0","0","0","0"
"3","DiskDeviceInfo.java","0","0","0","0","0"
"3","DiskInfo.java","0","0","0","0","0"
"3","DiskMountInfo.java","0","0","0","0","0"
"3","DiskUtil.java","0","0","0","0","0"
"3","AlreadyExistsStorageException.java","0","0","0","0","0"
"3","UnknownCodecException.java","0","0","0","0","0"
"3","UnsupportedFileTypeException.java","0","0","0","0","0"
"3","FormatProperty.java","0","0","0","0","0"
"3","BuiltinFragmentKinds.java","0","0","0","0","0"
"3","Fragment.java","0","0","0","0","0"
"3","FragmentConvertor.java","0","0","0","0","0"
"3","FragmentSerde.java","0","0","0","0","0"
"3","FrameTuple.java","82577","284823","367400","111018","37006.0"
"3","FSDataInputChannel.java","85801","148391","234192","85801","28600.0"
"3","InputChannel.java","0","0","0","0","0"
"3","LazyTuple.java","137868","356609","494477","137868","45956.0"
"3","LocalFileInputChannel.java","41398","95910","137308","41398","13799.0"
"3","MergeScanner.java","82600","306204","388804","115429","38476.0"
"3","NullScanner.java","106029","190576","296605","106029","35343.0"
"3","NumericPathComparator.java","0","0","0","0","0"
"3","OldStorageManager.java","0","0","0","0","0"
"3","RowStoreUtil.java","82577","284823","367400","122082","40694.0"
"3","Scanner.java","82600","306204","388804","82600","27533.0"
"3","SeekableChannel.java","0","0","0","0","0"
"3","SeekableInputChannel.java","0","0","0","0","0"
"3","SeekableScanner.java","0","0","0","0","0"
"3","SerializerDeserializer.java","117849","368326","486175","117849","39283.0"
"3","StorageProperty.java","82600","306204","388804","82600","27533.0"
"3","StorageUtil.java","82764","315340","398104","82764","27588.0"
"3","Tablespace.java","51242","115196","166438","51242","17080.0"
"3","TablespaceManager.java","16903","61846","78749","16903","5634.0"
"3","TableStatistics.java","143733","404428","548161","143733","47911.0"
"3","TextSerializerDeserializer.java","117863","327845","445708","127213","42404.0"
"3","TupleComparator.java","0","0","0","0","0"
"3","TupleRange.java","82577","284823","367400","82577","27525.0"
"3","TestFrameTuple.java","0","0","0","0","0"
"3","TestLazyTuple.java","90388","373387","463775","90388","30129.0"
"3","TestTupleComparator.java","82577","284823","367400","82577","27525.0"
"3","TestVTuple.java","0","0","0","0","0"
"3","AbstractHBaseAppender.java","71495","152828","224323","71495","23831.0"
"3","ColumnMapping.java","28414","38089","66503","28414","9471.0"
"3","HBaseBinarySerializerDeserializer.java","39567","67716","107283","39567","13189.0"
"3","HBaseFragment.java","0","0","0","0","0"
"3","HBaseFragmentSerde.java","0","0","0","0","0"
"3","HBasePutAppender.java","56224","128780","185004","56224","18741.0"
"3","HBaseScanner.java","28414","38089","66503","28414","9471.0"
"3","HBaseStorageConstants.java","0","0","0","0","0"
"3","HBaseTablespace.java","28414","38089","66503","28414","9471.0"
"3","HBaseTextSerializerDeserializer.java","0","0","0","0","0"
"3","HFileAppender.java","0","0","0","0","0"
"3","IndexPredication.java","0","0","0","0","0"
"3","RegionSizeCalculator.java","0","0","0","0","0"
"3","RowKeyMapping.java","82600","306204","388804","82600","27533.0"
"3","SortedInsertRewriter.java","56224","128780","185004","56224","18741.0"
"3","TestColumnMapping.java","116215","231739","347954","116215","38738.0"
"3","TestHBaseTableSpace.java","56224","128780","185004","56224","18741.0"
"3","AvroAppender.java","150175","271881","422056","150175","50058.0"
"3","AvroScanner.java","157001","351755","508756","157001","52333.0"
"3","AvroUtil.java","132915","241018","373933","132915","44305.0"
"3","package-info.java","0","0","0","0","0"
"3","FieldSerializerDeserializer.java","66502","110968","177470","66502","22167.0"
"3","FileAppender.java","82600","306204","388804","82600","27533.0"
"3","FileScanner.java","84545","415025","499570","84545","28181.0"
"3","FileTablespace.java","18317","90287","108604","18317","6105.0"
"3","AbstractFileFragment.java","0","0","0","0","0"
"3","FileFragment.java","0","0","0","0","0"
"3","FileFragmentSerde.java","0","0","0","0","0"
"3","HashShuffleAppenderManager.java","144643","343056","487699","144643","48214.0"
"3","HashShuffleAppenderWrapper.java","143976","336073","480049","143976","47992.0"
"3","BSTIndex.java","83983","381677","465660","127871","42623.0"
"3","IndexMethod.java","0","0","0","0","0"
"3","IndexReader.java","0","0","0","0","0"
"3","IndexWriter.java","0","0","0","0","0"
"3","OrderIndexReader.java","0","0","0","0","0"
"3","JsonLineDeserializer.java","30785","43428","74213","30785","10261.0"
"3","JsonLineSerDe.java","67681","108322","176003","67681","22560.0"
"3","JsonLineSerializer.java","90613","182630","273243","90613","30204.0"
"3","ORCAppender.java","5455","17689","23144","5455","1818.0"
"3","OrcScanner.java","0","0","0","0","0"
"3","package-info.java","0","0","0","0","0"
"3","package-info.java","0","0","0","0","0"
"3","ParquetAppender.java","153228","399798","553026","153228","51076.0"
"3","ParquetScanner.java","149994","354731","504725","149994","49998.0"
"3","TajoParquetReader.java","0","0","0","0","0"
"3","TajoParquetWriter.java","0","0","0","0","0"
"3","TajoReadSupport.java","143723","275412","419135","143723","47907.0"
"3","TajoRecordConverter.java","129306","249879","379185","129306","43102.0"
"3","TajoRecordMaterializer.java","153299","402479","555778","153299","51099.0"
"3","TajoSchemaConverter.java","0","0","0","0","0"
"3","TajoWriteSupport.java","149474","309432","458906","149474","49824.0"
"3","DirectRawFileScanner.java","105778","116572","222350","105778","35259.0"
"3","DirectRawFileWriter.java","4513","9802","14315","4513","1504.0"
"3","RawFile.java","82577","291771","374348","126492","42164.0"
"3","BytesRefArrayWritable.java","0","0","0","0","0"
"3","BytesRefWritable.java","0","0","0","0","0"
"3","ColumnProjectionUtils.java","0","0","0","0","0"
"3","LazyDecompressionCallback.java","0","0","0","0","0"
"3","NonSyncByteArrayInputStream.java","0","0","0","0","0"
"3","NonSyncByteArrayOutputStream.java","0","0","0","0","0"
"3","NonSyncDataInputBuffer.java","0","0","0","0","0"
"3","NonSyncDataOutputBuffer.java","0","0","0","0","0"
"3","RCFile.java","114934","296647","411581","128043","42681.0"
"3","SchemaAwareCompressionInputStream.java","0","0","0","0","0"
"3","SchemaAwareCompressionOutputStream.java","0","0","0","0","0"
"3","RegexLineDeserializer.java","0","0","0","0","0"
"3","RegexLineSerDe.java","0","0","0","0","0"
"3","RegexLineSerializer.java","0","0","0","0","0"
"3","SequenceFileAppender.java","145386","274053","419439","145386","48462.0"
"3","SequenceFileScanner.java","151394","308210","459604","151394","50464.0"
"3","ByteBufLineReader.java","4085","11290","15375","4085","1361.0"
"3","CSVLineDeserializer.java","57980","81059","139039","57980","19326.0"
"3","CSVLineSerDe.java","66186","103979","170165","66186","22062.0"
"3","CSVLineSerializer.java","57980","81059","139039","57980","19326.0"
"3","DelimitedLineReader.java","7451","16021","23472","7451","2483.0"
"3","DelimitedTextFile.java","3738","10411","14149","3738","1246.0"
"3","FieldSplitProcessor.java","0","0","0","0","0"
"3","LineSplitProcessor.java","0","0","0","0","0"
"3","MultiBytesFieldSplitProcessor.java","0","0","0","0","0"
"3","TextFieldSerializerDeserializer.java","1479","7317","8796","1479","493.0"
"3","TextLineDeserializer.java","66186","103979","170165","66186","22062.0"
"3","TextLineParsingError.java","0","0","0","0","0"
"3","TextLineSerDe.java","66186","103979","170165","66186","22062.0"
"3","TextLineSerializer.java","1668","4550","6218","1668","556.0"
"3","ByteBufferAllocatorPool.java","0","0","0","0","0"
"3","ByteBufferPoolAdapter.java","0","0","0","0","0"
"3","OrcConf.java","0","0","0","0","0"
"3","OrcFile.java","0","0","0","0","0"
"3","OrcRecordReader.java","0","0","0","0","0"
"3","OrcUtils.java","0","0","0","0","0"
"3","package-info.java","0","0","0","0","0"
"3","RecordReaderUtils.java","0","0","0","0","0"
"3","TreeReaderFactory.java","0","0","0","0","0"
"3","BloomFilter.java","0","0","0","0","0"
"3","Murmur3.java","0","0","0","0","0"
"3","Writer.java","0","0","0","0","0"
"3","WriterImpl.java","0","0","0","0","0"
"3","ZeroCopyAdapter.java","0","0","0","0","0"
"3","InternalParquetRecordReader.java","0","0","0","0","0"
"3","ParquetReader.java","0","0","0","0","0"
"3","HttpFileServer.java","57242","79043","136285","57242","19080.0"
"3","HttpFileServerChannelInitializer.java","0","0","0","0","0"
"3","HttpFileServerHandler.java","57242","79043","136285","57242","19080.0"
"3","TestAvroUtil.java","129588","258715","388303","129588","43196.0"
"3","TestBSTIndex.java","82577","284823","367400","82577","27525.0"
"3","TestSingleCSVFileBSTIndex.java","82577","284823","367400","82577","27525.0"
"3","TestJsonSerDe.java","122663","219137","341800","122663","40887.0"
"3","TestReadWrite.java","143723","275412","419135","143723","47907.0"
"3","TestSchemaConverter.java","0","0","0","0","0"
"3","TestDirectRawFile.java","105778","116572","222350","105778","35259.0"
"3","TestRegexSerDe.java","0","0","0","0","0"
"3","TestByteBufLineReader.java","0","0","0","0","0"
"3","TestCompressionStorages.java","79220","284277","363497","117689","39229.0"
"3","TestDelimitedTextFile.java","31079","43203","74282","31079","10359.0"
"3","TestFileSystems.java","30172","43507","73679","30172","10057.0"
"3","TestFileTablespace.java","82600","306204","388804","82600","27533.0"
"3","TestLineReader.java","4085","11290","15375","4085","1361.0"
"3","TestMergeScanner.java","83578","335331","418909","83578","27859.0"
"3","TestSplitProcessor.java","58383","88135","146518","58383","19461.0"
"3","TestStorages.java","82577","291771","374348","121315","40438.0"
"3","TestStorageUtil.java","0","0","0","0","0"
"3","ConnectionInfo.java","0","0","0","0","0"
"3","JdbcFragment.java","0","0","0","0","0"
"3","JdbcFragmentSerde.java","0","0","0","0","0"
"3","JdbcMetadataProviderBase.java","0","0","0","0","0"
"3","JdbcScanner.java","0","0","0","0","0"
"3","JdbcTablespace.java","0","0","0","0","0"
"3","SQLBuilder.java","0","0","0","0","0"
"3","SQLExpressionGenerator.java","0","0","0","0","0"
"3","TestConnectionInfo.java","0","0","0","0","0"
"3","KafkaFragment.java","0","0","0","0","0"
"3","KafkaFragmentSerde.java","0","0","0","0","0"
"3","KafkaScanner.java","0","0","0","0","0"
"3","KafkaStorageConstants.java","0","0","0","0","0"
"3","KafkaTablespace.java","0","0","0","0","0"
"3","SimpleConsumerManager.java","0","0","0","0","0"
"3","KafkaTestUtil.java","0","0","0","0","0"
"3","EmbeddedKafka.java","0","0","0","0","0"
"3","EmbeddedZookeeper.java","0","0","0","0","0"
"3","TestKafkaQuery.java","0","0","0","0","0"
"3","TestKafkaScanner.java","0","0","0","0","0"
"3","TestKafkaTablespace.java","0","0","0","0","0"
"3","TestSimpleConsumerManager.java","0","0","0","0","0"
"3","PgSQLJdbcScanner.java","0","0","0","0","0"
"3","PgSQLMetadataProvider.java","0","0","0","0","0"
"3","PgSQLTablespace.java","0","0","0","0","0"
"3","PgSQLTestServer.java","0","0","0","0","0"
"3","TestPgSQLEndPointTests.java","0","0","0","0","0"
"3","TestPgSQLJdbcTableSpace.java","446","708","1154","446","148.0"
"3","TestPgSQLMetadataProvider.java","0","0","0","0","0"
"3","TestPgSQLQueryTests.java","0","0","0","0","0"
"3","TestPgSQLSimpleQueryTests.java","0","0","0","0","0"
"3","AnonymousAWSCredentialsProvider.java","0","0","0","0","0"
"3","BasicAWSCredentialsProvider.java","0","0","0","0","0"
"3","S3TableSpace.java","1998","1485","3483","1998","666.0"
"3","TajoS3Constants.java","0","0","0","0","0"
"3","MockAmazonS3.java","0","0","0","0","0"
"3","MockObjectListing.java","0","0","0","0","0"
"3","MockS3FileSystem.java","0","0","0","0","0"
"3","TestS3TableSpace.java","0","0","0","0","0"
"3","ExampleHttpFileFragment.java","0","0","0","0","0"
"3","ExampleHttpFileFragmentSerde.java","0","0","0","0","0"
"3","ExampleHttpFileTablespace.java","0","0","0","0","0"
"3","ExampleHttpJsonLineReader.java","0","0","0","0","0"
"3","ExampleHttpJsonScanner.java","0","0","0","0","0"
"3","ExampleHttpServerHandler.java","0","0","0","0","0"
"3","ExampleHttpServerInitializer.java","0","0","0","0","0"
"3","ExampleHttpTablespaceTestServer.java","0","0","0","0","0"
"3","TestExampleHttpFileQuery.java","0","0","0","0","0"
"3","AnnotationVisitor.java","0","0","0","0","0"
"3","AnnotationWriter.java","0","0","0","0","0"
"3","Attribute.java","0","0","0","0","0"
"3","ByteVector.java","0","0","0","0","0"
"3","ClassReader.java","0","0","0","0","0"
"3","ClassVisitor.java","0","0","0","0","0"
"3","ClassWriter.java","0","0","0","0","0"
"3","AdviceAdapter.java","0","0","0","0","0"
"3","AnalyzerAdapter.java","145946","289520","435466","145946","48648.0"
"3","CodeSizeEvaluator.java","0","0","0","0","0"
"3","GeneratorAdapter.java","0","0","0","0","0"
"3","InstructionAdapter.java","0","0","0","0","0"
"3","JSRInlinerAdapter.java","145946","289520","435466","145946","48648.0"
"3","LocalVariablesSorter.java","0","0","0","0","0"
"3","Method.java","0","0","0","0","0"
"3","Remapper.java","0","0","0","0","0"
"3","RemappingAnnotationAdapter.java","0","0","0","0","0"
"3","RemappingClassAdapter.java","0","0","0","0","0"
"3","RemappingFieldAdapter.java","0","0","0","0","0"
"3","RemappingMethodAdapter.java","0","0","0","0","0"
"3","RemappingSignatureAdapter.java","0","0","0","0","0"
"3","SerialVersionUIDAdder.java","0","0","0","0","0"
"3","SimpleRemapper.java","0","0","0","0","0"
"3","StaticInitMerger.java","0","0","0","0","0"
"3","TableSwitchGenerator.java","0","0","0","0","0"
"3","TryCatchBlockSorter.java","0","0","0","0","0"
"3","Context.java","0","0","0","0","0"
"3","Edge.java","0","0","0","0","0"
"3","FieldVisitor.java","0","0","0","0","0"
"3","FieldWriter.java","0","0","0","0","0"
"3","Frame.java","0","0","0","0","0"
"3","Handle.java","0","0","0","0","0"
"3","Handler.java","0","0","0","0","0"
"3","Item.java","0","0","0","0","0"
"3","Label.java","0","0","0","0","0"
"3","MethodVisitor.java","0","0","0","0","0"
"3","MethodWriter.java","0","0","0","0","0"
"3","Opcodes.java","0","0","0","0","0"
"3","AnnotationConstantsCollector.java","0","0","0","0","0"
"3","ClassConstantsCollector.java","0","0","0","0","0"
"3","ClassOptimizer.java","0","0","0","0","0"
"3","Constant.java","0","0","0","0","0"
"3","ConstantPool.java","0","0","0","0","0"
"3","FieldConstantsCollector.java","0","0","0","0","0"
"3","JarOptimizer.java","0","0","0","0","0"
"3","MethodConstantsCollector.java","0","0","0","0","0"
"3","MethodOptimizer.java","0","0","0","0","0"
"3","NameMapping.java","0","0","0","0","0"
"3","Shrinker.java","0","0","0","0","0"
"3","SignatureReader.java","0","0","0","0","0"
"3","SignatureVisitor.java","0","0","0","0","0"
"3","SignatureWriter.java","0","0","0","0","0"
"3","AbstractInsnNode.java","0","0","0","0","0"
"3","Analyzer.java","145946","289520","435466","145946","48648.0"
"3","AnalyzerException.java","0","0","0","0","0"
"3","BasicInterpreter.java","0","0","0","0","0"
"3","BasicValue.java","0","0","0","0","0"
"3","BasicVerifier.java","0","0","0","0","0"
"3","Frame.java","0","0","0","0","0"
"3","Interpreter.java","0","0","0","0","0"
"3","SimpleVerifier.java","0","0","0","0","0"
"3","SmallSet.java","0","0","0","0","0"
"3","SourceInterpreter.java","0","0","0","0","0"
"3","SourceValue.java","0","0","0","0","0"
"3","Subroutine.java","0","0","0","0","0"
"3","Value.java","0","0","0","0","0"
"3","AnnotationNode.java","0","0","0","0","0"
"3","ClassNode.java","0","0","0","0","0"
"3","FieldInsnNode.java","0","0","0","0","0"
"3","FieldNode.java","0","0","0","0","0"
"3","FrameNode.java","0","0","0","0","0"
"3","IincInsnNode.java","0","0","0","0","0"
"3","InnerClassNode.java","0","0","0","0","0"
"3","InsnList.java","0","0","0","0","0"
"3","InsnNode.java","0","0","0","0","0"
"3","IntInsnNode.java","0","0","0","0","0"
"3","InvokeDynamicInsnNode.java","0","0","0","0","0"
"3","JumpInsnNode.java","0","0","0","0","0"
"3","LabelNode.java","0","0","0","0","0"
"3","LdcInsnNode.java","0","0","0","0","0"
"3","LineNumberNode.java","0","0","0","0","0"
"3","LocalVariableNode.java","0","0","0","0","0"
"3","LookupSwitchInsnNode.java","0","0","0","0","0"
"3","MethodInsnNode.java","0","0","0","0","0"
"3","MethodNode.java","0","0","0","0","0"
"3","MultiANewArrayInsnNode.java","0","0","0","0","0"
"3","TableSwitchInsnNode.java","0","0","0","0","0"
"3","TryCatchBlockNode.java","0","0","0","0","0"
"3","TypeInsnNode.java","0","0","0","0","0"
"3","VarInsnNode.java","0","0","0","0","0"
"3","Type.java","0","0","0","0","0"
"3","ASMifiable.java","0","0","0","0","0"
"3","ASMifier.java","0","0","0","0","0"
"3","CheckAnnotationAdapter.java","0","0","0","0","0"
"3","CheckClassAdapter.java","0","0","0","0","0"
"3","CheckFieldAdapter.java","0","0","0","0","0"
"3","CheckMethodAdapter.java","145946","289520","435466","145946","48648.0"
"3","CheckSignatureAdapter.java","0","0","0","0","0"
"3","Printer.java","0","0","0","0","0"
"3","Textifiable.java","0","0","0","0","0"
"3","Textifier.java","0","0","0","0","0"
"3","TraceAnnotationVisitor.java","0","0","0","0","0"
"3","TraceClassVisitor.java","0","0","0","0","0"
"3","TraceFieldVisitor.java","0","0","0","0","0"
"3","TraceMethodVisitor.java","0","0","0","0","0"
"3","TraceSignatureVisitor.java","0","0","0","0","0"
"3","ASMContentHandler.java","145946","289520","435466","145946","48648.0"
"3","Processor.java","0","0","0","0","0"
"3","SAXAdapter.java","0","0","0","0","0"
"3","SAXAnnotationAdapter.java","0","0","0","0","0"
"3","SAXClassAdapter.java","0","0","0","0","0"
"3","SAXCodeAdapter.java","0","0","0","0","0"
"3","SAXFieldAdapter.java","0","0","0","0","0"
"3","FadvisedChunkedFile.java","84814","126137","210951","84814","28271.0"
"3","FadvisedFileRegion.java","84814","126137","210951","84814","28271.0"
"3","FileCloseListener.java","144714","284640","429354","144714","48238.0"
"3","TajoPullServerService.java","80046","312543","392589","124991","41663.0"
"4","Aggregation.java","0","0","0","0","0"
"4","AlterTable.java","148493","299624","448117","148493","37123.0"
"4","AlterTableOpType.java","0","0","0","0","0"
"4","AlterTablespace.java","0","0","0","0","0"
"4","AlterTablespaceSetType.java","0","0","0","0","0"
"4","BetweenPredicate.java","0","0","0","0","0"
"4","BinaryOperator.java","0","0","0","0","0"
"4","BooleanLiteral.java","0","0","0","0","0"
"4","CaseWhenPredicate.java","0","0","0","0","0"
"4","CastExpr.java","0","0","0","0","0"
"4","ColumnDefinition.java","0","0","0","0","0"
"4","ColumnReferenceExpr.java","0","0","0","0","0"
"4","CommonSubquery.java","0","0","0","0","0"
"4","CountRowsFunctionExpr.java","0","0","0","0","0"
"4","CreateDatabase.java","0","0","0","0","0"
"4","CreateIndex.java","0","0","0","0","0"
"4","CreateTable.java","76720","327654","404374","129800","32450.0"
"4","DataTypeExpr.java","92271","312868","405139","130202","32550.0"
"4","DateLiteral.java","0","0","0","0","0"
"4","DateValue.java","0","0","0","0","0"
"4","DropDatabase.java","0","0","0","0","0"
"4","DropIndex.java","0","0","0","0","0"
"4","DropTable.java","0","0","0","0","0"
"4","ExistsPredicate.java","0","0","0","0","0"
"4","Explain.java","152138","291070","443208","152138","38034.0"
"4","Expr.java","0","0","0","0","0"
"4","ExprVisitor.java","0","0","0","0","0"
"4","FunctionExpr.java","0","0","0","0","0"
"4","GeneralSetFunctionExpr.java","0","0","0","0","0"
"4","Having.java","0","0","0","0","0"
"4","InPredicate.java","0","0","0","0","0"
"4","Insert.java","82480","385005","467485","82480","20620.0"
"4","IntervalLiteral.java","0","0","0","0","0"
"4","IsNullPredicate.java","0","0","0","0","0"
"4","Join.java","0","0","0","0","0"
"4","JoinType.java","0","0","0","0","0"
"4","JsonHelper.java","0","0","0","0","0"
"4","JsonSerializable.java","0","0","0","0","0"
"4","Limit.java","0","0","0","0","0"
"4","LiteralValue.java","0","0","0","0","0"
"4","NamedExpr.java","0","0","0","0","0"
"4","NotExpr.java","0","0","0","0","0"
"4","NullLiteral.java","0","0","0","0","0"
"4","OpType.java","0","0","0","0","0"
"4","PatternMatchPredicate.java","0","0","0","0","0"
"4","Projection.java","0","0","0","0","0"
"4","QualifiedAsteriskExpr.java","0","0","0","0","0"
"4","Relation.java","77329","389852","467181","77329","19332.0"
"4","RelationList.java","77329","389852","467181","77329","19332.0"
"4","ScalarSubQuery.java","0","0","0","0","0"
"4","Selection.java","0","0","0","0","0"
"4","SetOperation.java","0","0","0","0","0"
"4","SetSession.java","0","0","0","0","0"
"4","SignedExpr.java","0","0","0","0","0"
"4","SimpleTableSubquery.java","84209","390783","474992","84209","21052.0"
"4","Sort.java","84587","423733","508320","127179","31794.0"
"4","TablePrimarySubQuery.java","84209","390783","474992","84209","21052.0"
"4","TimeLiteral.java","0","0","0","0","0"
"4","TimestampLiteral.java","0","0","0","0","0"
"4","TimeValue.java","0","0","0","0","0"
"4","TruncateTable.java","0","0","0","0","0"
"4","UnaryOperator.java","0","0","0","0","0"
"4","ValueListExpr.java","0","0","0","0","0"
"4","Window.java","0","0","0","0","0"
"4","WindowFunctionExpr.java","0","0","0","0","0"
"4","WindowSpec.java","0","0","0","0","0"
"4","AlgebraTestingUtil.java","0","0","0","0","0"
"4","TestExpr.java","0","0","0","0","0"
"4","AbstractCatalogClient.java","83604","321973","405577","149862","37465.0"
"4","CatalogClient.java","83576","334269","417845","83576","20894.0"
"4","AlreadyRegisteredURIException.java","0","0","0","0","0"
"4","AlterTableDesc.java","148386","292901","441287","148386","37096.0"
"4","AlterTableType.java","0","0","0","0","0"
"4","AttributeType.java","0","0","0","0","0"
"4","CatalogConstants.java","0","0","0","0","0"
"4","CatalogService.java","148637","360175","508812","149862","37465.0"
"4","CatalogUtil.java","82779","315961","398740","134037","33509.0"
"4","Column.java","82779","315961","398740","82779","20694.0"
"4","DDLBuilder.java","99690","310122","409812","99690","24922.0"
"4","FieldConverter.java","0","0","0","0","0"
"4","FunctionDesc.java","84208","389145","473353","129084","32271.0"
"4","FunctionDescBuilder.java","0","0","0","0","0"
"4","IndexDesc.java","84059","384589","468648","84059","21014.0"
"4","IndexMeta.java","0","0","0","0","0"
"4","CatalogGsonHelper.java","0","0","0","0","0"
"4","FunctionAdapter.java","0","0","0","0","0"
"4","SchemaAdapter.java","0","0","0","0","0"
"4","TableMetaAdapter.java","84587","423715","508302","84587","21146.0"
"4","ListSchemaBuilder.java","0","0","0","0","0"
"4","MetadataProvider.java","110444","136696","247140","110444","27611.0"
"4","NestedPathUtil.java","0","0","0","0","0"
"4","PartitionDesc.java","129979","310376","440355","129979","32494.0"
"4","PartitionMethodDesc.java","0","0","0","0","0"
"4","Schema.java","83578","335331","418909","83578","20894.0"
"4","SchemaBuilder.java","0","0","0","0","0"
"4","SchemaFactory.java","0","0","0","0","0"
"4","SchemaLegacy.java","0","0","0","0","0"
"4","SchemaObject.java","0","0","0","0","0"
"4","SchemaUtil.java","82779","315961","398740","130690","32672.0"
"4","SetSchemaBuilder.java","0","0","0","0","0"
"4","SortSpec.java","84587","423733","508320","84587","21146.0"
"4","ColumnStats.java","0","0","0","0","0"
"4","Stat.java","0","0","0","0","0"
"4","StatisticsUtil.java","0","0","0","0","0"
"4","StatSet.java","0","0","0","0","0"
"4","TableStats.java","84547","417220","501767","123852","30963.0"
"4","TableDesc.java","114710","409530","524240","130877","32719.0"
"4","TableMeta.java","113467","328010","441477","113467","28366.0"
"4","TypeConverter.java","0","0","0","0","0"
"4","TypeDesc.java","0","0","0","0","0"
"4","DataTypeUtil.java","0","0","0","0","0"
"4","ClassBaseInvocationDesc.java","0","0","0","0","0"
"4","Function.java","0","0","0","0","0"
"4","FunctionCollection.java","0","0","0","0","0"
"4","FunctionInvocation.java","92487","142115","234602","92487","23121.0"
"4","FunctionSignature.java","93100","145230","238330","93100","23275.0"
"4","FunctionSupplement.java","0","0","0","0","0"
"4","FunctionUtil.java","93100","145230","238330","93100","23275.0"
"4","ScalarFunction.java","0","0","0","0","0"
"4","StaticMethodInvocationDesc.java","0","0","0","0","0"
"4","UDFInvocationDesc.java","1668","4550","6218","1668","417.0"
"4","TestColumnStat.java","0","0","0","0","0"
"4","TestStatisticsUtil.java","0","0","0","0","0"
"4","TestStatSet.java","0","0","0","0","0"
"4","TestTableStat.java","0","0","0","0","0"
"4","TestCatalogUtil.java","0","0","0","0","0"
"4","TestColumn.java","0","0","0","0","0"
"4","TestFunctionDesc.java","83614","332037","415651","83614","20903.0"
"4","TestIndexDesc.java","84059","384589","468648","84059","21014.0"
"4","TestKeyValueSet.java","0","0","0","0","0"
"4","TestSchema.java","82779","315961","398740","82779","20694.0"
"4","TestTableDesc.java","83566","379726","463292","83566","20891.0"
"4","TestTableMeta.java","75228","333817","409045","75228","18807.0"
"4","HCatalogStore.java","0","0","0","0","0"
"4","HiveCatalogStore.java","115299","314281","429580","149862","37465.0"
"4","HiveCatalogStoreClientPool.java","129956","311803","441759","129956","32489.0"
"4","HiveCatalogUtil.java","115321","320368","435689","115321","28830.0"
"4","TestHiveCatalogStore.java","128468","310631","439099","129161","32290.0"
"4","CatalogServer.java","83604","321973","405577","149862","37465.0"
"4","AbstractTableDescriptor.java","0","0","0","0","0"
"4","ClusterTableDescriptor.java","0","0","0","0","0"
"4","ColumnDescriptor.java","0","0","0","0","0"
"4","ColumnsTableDescriptor.java","0","0","0","0","0"
"4","DatabasesTableDescriptor.java","0","0","0","0","0"
"4","IndexesTableDescriptor.java","0","0","0","0","0"
"4","InfoSchemaMetadataDictionary.java","46802","104730","151532","46802","11700.0"
"4","PartitionKeysTableDescriptor.java","0","0","0","0","0"
"4","PartitionsTableDescriptor.java","0","0","0","0","0"
"4","SessionTableDescriptor.java","0","0","0","0","0"
"4","TableDescriptor.java","0","0","0","0","0"
"4","TableOptionsTableDescriptor.java","0","0","0","0","0"
"4","TablespacesTableDescriptor.java","0","0","0","0","0"
"4","TablesTableDescriptor.java","0","0","0","0","0"
"4","TableStatsTableDescriptor.java","0","0","0","0","0"
"4","LinkedMetadataManager.java","109588","120665","230253","109588","27397.0"
"4","LocalCatalogWrapper.java","0","0","0","0","0"
"4","AbstractDBStore.java","142394","286584","428978","150096","37524.0"
"4","CatalogStore.java","83604","321973","405577","130882","32720.0"
"4","DerbyStore.java","103820","383090","486910","141894","35473.0"
"4","MariaDBStore.java","86193","201886","288079","86193","21548.0"
"4","MySQLStore.java","103083","315758","418841","103083","25770.0"
"4","BaseSchema.java","0","0","0","0","0"
"4","DatabaseObject.java","0","0","0","0","0"
"4","DatabaseObjectType.java","0","0","0","0","0"
"4","SchemaPatch.java","0","0","0","0","0"
"4","SQLObject.java","0","0","0","0","0"
"4","StoreObject.java","0","0","0","0","0"
"4","OracleStore.java","114648","219918","334566","114648","28662.0"
"4","PostgreSQLStore.java","114239","219967","334206","114239","28559.0"
"4","XMLCatalogSchemaManager.java","79600","165616","245216","79600","19900.0"
"4","CatalogTestingUtil.java","3578","4807","8385","3578","894.0"
"4","MiniCatalogServer.java","0","0","0","0","0"
"4","TestXMLCatalogSchemaManager.java","0","0","0","0","0"
"4","TestCatalog.java","82779","315961","398740","149862","37465.0"
"4","TestCatalogAgainstCaseSensitivity.java","4220","26048","30268","4220","1055.0"
"4","TestCatalogExceptions.java","3451","24548","27999","3451","862.0"
"4","TestLinkedMetadataManager.java","100438","105248","205686","100438","25109.0"
"4","TajoAdmin.java","129588","304639","434227","150118","37529.0"
"4","TajoDump.java","101062","376143","477205","151146","37786.0"
"4","TajoGetConf.java","0","0","0","0","0"
"4","TajoHAAdmin.java","91334","204836","296170","91334","22833.0"
"4","CliClientParamsFactory.java","0","0","0","0","0"
"4","ConnectDatabaseCommand.java","148691","362497","511188","148691","37172.0"
"4","CopyrightCommand.java","0","0","0","0","0"
"4","DescFunctionCommand.java","135281","316453","451734","135281","33820.0"
"4","DescTableCommand.java","136417","367194","503611","136417","34104.0"
"4","ExecExternalShellCommand.java","0","0","0","0","0"
"4","ExitCommand.java","0","0","0","0","0"
"4","HdfsCommand.java","0","0","0","0","0"
"4","HelpCommand.java","0","0","0","0","0"
"4","ListDatabaseCommand.java","0","0","0","0","0"
"4","SetCommand.java","148435","356165","504600","148435","37108.0"
"4","TajoAdminCommand.java","0","0","0","0","0"
"4","TajoGetConfCommand.java","0","0","0","0","0"
"4","TajoHAAdminCommand.java","0","0","0","0","0"
"4","TajoShellCommand.java","136652","371836","508488","136652","34163.0"
"4","UnsetCommand.java","0","0","0","0","0"
"4","VersionCommand.java","0","0","0","0","0"
"4","DefaultTajoCliOutputFormatter.java","82817","215738","298555","82817","20704.0"
"4","InvalidStatementException.java","0","0","0","0","0"
"4","ParsedResult.java","0","0","0","0","0"
"4","SimpleParser.java","146576","306227","452803","148986","37246.0"
"4","TajoCli.java","82764","315397","398161","150118","37529.0"
"4","TajoCliOutputFormatter.java","0","0","0","0","0"
"4","TajoFileHistory.java","0","0","0","0","0"
"4","CatalogAdminClient.java","85925","189379","275304","85925","21481.0"
"4","CatalogAdminClientImpl.java","64266","117883","182149","64266","16066.0"
"4","ClientParameterHelper.java","0","0","0","0","0"
"4","ClientParameters.java","0","0","0","0","0"
"4","DummyServiceTracker.java","19961","43005","62966","19961","4990.0"
"4","InvalidClientSessionException.java","84062","386860","470922","84062","21015.0"
"4","QueryClient.java","60175","102165","162340","60175","15043.0"
"4","QueryClientImpl.java","60175","102165","162340","60175","15043.0"
"4","QueryStatus.java","0","0","0","0","0"
"4","ResultSetUtil.java","128699","377153","505852","133916","33479.0"
"4","SessionConnection.java","54524","90081","144605","56397","14099.0"
"4","TajoClient.java","97990","103158","201148","97990","24497.0"
"4","TajoClientImpl.java","60175","102165","162340","60175","15043.0"
"4","TajoClientUtil.java","76294","174373","250667","76294","19073.0"
"4","ClientDelegate.java","0","0","0","0","0"
"4","ClientDelegateFactory.java","0","0","0","0","0"
"4","ClientUtil.java","0","0","0","0","0"
"4","ClientConnectionException.java","0","0","0","0","0"
"4","ClientUnableToConnectException.java","0","0","0","0","0"
"4","FutureListener.java","0","0","0","0","0"
"4","LegacyClientDelegate.java","3446","5585","9031","3446","861.0"
"4","QueryFuture.java","0","0","0","0","0"
"4","QueryState.java","0","0","0","0","0"
"4","ServiceDiscovery.java","0","0","0","0","0"
"4","TajoClient.java","97990","103158","201148","97990","24497.0"
"4","FetchResultSet.java","89987","137429","227416","89987","22496.0"
"4","MetaDataTuple.java","137868","356609","494477","137868","34467.0"
"4","TajoMemoryResultSet.java","154934","351541","506475","154934","38733.0"
"4","TajoMetaDataResultSet.java","0","0","0","0","0"
"4","TajoResultSetBase.java","117884","368459","486343","128562","32140.0"
"4","TajoResultSetMetaData.java","0","0","0","0","0"
"4","TajoSQLException.java","0","0","0","0","0"
"4","WaitingResultSet.java","0","0","0","0","0"
"4","RowStoreUtil.java","83580","335453","419033","149253","37313.0"
"4","TableExample.java","0","0","0","0","0"
"4","TajoClientAsyncExample.java","0","0","0","0","0"
"4","TajoClientExample.java","0","0","0","0","0"
"4","BackendTestingUtil.java","90361","388943","479304","90361","22590.0"
"4","CatalogTestingUtil.java","3578","4807","8385","3578","894.0"
"4","HBaseTestClusterUtil.java","0","0","0","0","0"
"4","IntegrationTest.java","0","0","0","0","0"
"4","LocalTajoTestingUtility.java","0","0","0","0","0"
"4","NamedTest.java","0","0","0","0","0"
"4","QueryTestCaseBase.java","129021","304187","433208","150312","37578.0"
"4","TajoTestingCluster.java","83604","321755","405359","141658","35414.0"
"4","TpchTestBase.java","84219","392901","477120","84219","21054.0"
"4","NotNull.java","0","0","0","0","0"
"4","NotThreadSafe.java","0","0","0","0","0"
"4","Nullable.java","0","0","0","0","0"
"4","ThreadSafe.java","0","0","0","0","0"
"4","Assert.java","0","0","0","0","0"
"4","UserRoleInfo.java","0","0","0","0","0"
"4","BuiltinStorages.java","0","0","0","0","0"
"4","ProtoObject.java","0","0","0","0","0"
"4","Sleeper.java","0","0","0","0","0"
"4","IPv4.java","0","0","0","0","0"
"4","TajoTypeUtil.java","0","0","0","0","0"
"4","TimeRange.java","0","0","0","0","0"
"4","TajoConf.java","57878","94964","152842","117029","29257.0"
"4","ConfigKey.java","0","0","0","0","0"
"4","AnyDatum.java","0","0","0","0","0"
"4","BitDatum.java","0","0","0","0","0"
"4","BlobDatum.java","83614","332037","415651","83614","20903.0"
"4","BooleanDatum.java","0","0","0","0","0"
"4","CharDatum.java","0","0","0","0","0"
"4","DateDatum.java","125538","317448","442986","128918","32229.0"
"4","Datum.java","131844","399778","531622","131844","32961.0"
"4","DatumFactory.java","66637","102578","169215","127233","31808.0"
"4","Float4Datum.java","83604","328468","412072","127967","31991.0"
"4","Float8Datum.java","83604","328468","412072","127967","31991.0"
"4","Int2Datum.java","83604","328468","412072","127967","31991.0"
"4","Int4Datum.java","83604","328468","412072","127967","31991.0"
"4","Int8Datum.java","83604","328468","412072","127967","31991.0"
"4","IntervalDatum.java","84600","225198","309798","84600","21150.0"
"4","NullDatum.java","0","0","0","0","0"
"4","NumericDatum.java","0","0","0","0","0"
"4","AbstractCharBasedFormatter.java","0","0","0","0","0"
"4","ProtobufFormatter.java","0","0","0","0","0"
"4","ProtobufJsonFormat.java","0","0","0","0","0"
"4","TextUtils.java","0","0","0","0","0"
"4","ProtobufDatum.java","0","0","0","0","0"
"4","ProtobufDatumFactory.java","98160","405035","503195","98160","24540.0"
"4","TextDatum.java","83603","320421","404024","126650","31662.0"
"4","TimeDatum.java","125689","317250","442939","125998","31499.0"
"4","TimestampDatum.java","125364","318356","443720","128837","32209.0"
"4","AmbiguousColumnException.java","0","0","0","0","0"
"4","AmbiguousFunctionException.java","3446","5585","9031","3446","861.0"
"4","AmbiguousPartitionDirectoryExistException.java","24737","27752","52489","24737","6184.0"
"4","AmbiguousTableException.java","0","0","0","0","0"
"4","CannotDropCurrentDatabaseException.java","84547","420781","505328","84547","21136.0"
"4","CatalogUpgradeRequiredException.java","84208","389145","473353","84208","21052.0"
"4","DataTypeMismatchException.java","84062","386860","470922","84062","21015.0"
"4","DefaultTajoException.java","84208","389145","473353","84208","21052.0"
"4","DividedByZeroException.java","84547","420781","505328","84547","21136.0"
"4","DuplicateColumnException.java","83983","380705","464688","83983","20995.0"
"4","DuplicateDatabaseException.java","83983","380705","464688","83983","20995.0"
"4","DuplicateFunctionException.java","84062","386860","470922","84062","21015.0"
"4","DuplicateIndexException.java","84208","389145","473353","84208","21052.0"
"4","DuplicatePartitionException.java","84208","389145","473353","84208","21052.0"
"4","DuplicateTableException.java","84208","389145","473353","84208","21052.0"
"4","DuplicateTablespaceException.java","83983","380705","464688","83983","20995.0"
"4","ErrorMessages.java","1011","1614","2625","1011","252.0"
"4","ErrorUtil.java","0","0","0","0","0"
"4","ExceptionUtil.java","11470","19685","31155","11470","2867.0"
"4","InsufficientPrivilegeException.java","3254","3963","7217","3254","813.0"
"4","InvalidAddressException.java","0","0","0","0","0"
"4","InvalidDataTypeException.java","114440","374153","488593","114440","28610.0"
"4","InvalidInputsForCrossJoin.java","0","0","0","0","0"
"4","InvalidNameException.java","83983","380705","464688","83983","20995.0"
"4","InvalidOperationException.java","0","0","0","0","0"
"4","InvalidSessionException.java","84062","386860","470922","84062","21015.0"
"4","InvalidSessionVariableException.java","84547","420781","505328","84547","21136.0"
"4","InvalidTablePropertyException.java","84062","386860","470922","84062","21015.0"
"4","InvalidURLException.java","84547","420781","505328","84547","21136.0"
"4","InvalidValueForCastException.java","84377","410628","495005","84377","21094.0"
"4","LMDNoMatchedDatatypeException.java","84062","386860","470922","84062","21015.0"
"4","MetadataConnectionException.java","83983","380705","464688","83983","20995.0"
"4","MissingTablePropertyException.java","84062","386860","470922","84062","21015.0"
"4","NoSuchSessionVariableException.java","83983","380705","464688","83983","20995.0"
"4","NotImplementedException.java","0","0","0","0","0"
"4","QueryFailedException.java","84062","386860","470922","84062","21015.0"
"4","QueryKilledException.java","84062","386860","470922","84062","21015.0"
"4","QueryNotFoundException.java","84062","386860","470922","84062","21015.0"
"4","ReturnStateUtil.java","7595","11403","18998","7595","1898.0"
"4","SQLExceptionUtil.java","8785","14861","23646","8785","2196.0"
"4","SQLSyntaxError.java","0","0","0","0","0"
"4","TajoError.java","8785","14861","23646","8785","2196.0"
"4","TajoException.java","8785","14861","23646","8785","2196.0"
"4","TajoInternalError.java","114440","374153","488593","114440","28610.0"
"4","TajoRuntimeException.java","1011","1614","2625","1011","252.0"
"4","TooLargeInputForCrossJoinException.java","0","0","0","0","0"
"4","UnavailableTableLocationException.java","84062","386860","470922","84062","21015.0"
"4","UndefinedColumnException.java","83983","380705","464688","83983","20995.0"
"4","UndefinedDatabaseException.java","83983","380705","464688","83983","20995.0"
"4","UndefinedFunctionException.java","84062","386860","470922","84062","21015.0"
"4","UndefinedIndexException.java","83983","380705","464688","83983","20995.0"
"4","UndefinedOperatorException.java","114440","374153","488593","114440","28610.0"
"4","UndefinedPartitionException.java","0","0","0","0","0"
"4","UndefinedPartitionKeyException.java","24737","27752","52489","24737","6184.0"
"4","UndefinedPartitionMethodException.java","24737","27752","52489","24737","6184.0"
"4","UndefinedTableException.java","83983","380705","464688","83983","20995.0"
"4","UndefinedTablespaceException.java","83983","380705","464688","83983","20995.0"
"4","UndefinedTablespaceHandlerException.java","0","0","0","0","0"
"4","UnknownDataFormatException.java","84062","386860","470922","84062","21015.0"
"4","UnremovableTablePropertyException.java","0","0","0","0","0"
"4","UnsupportedCatalogStore.java","0","0","0","0","0"
"4","UnsupportedDataTypeException.java","84208","389145","473353","84208","21052.0"
"4","UnsupportedException.java","0","0","0","0","0"
"4","ValueOutOfRangeException.java","0","0","0","0","0"
"4","ValueTooLongForTypeCharactersException.java","0","0","0","0","0"
"4","ExecutionBlockId.java","0","0","0","0","0"
"4","HAConstants.java","0","0","0","0","0"
"4","ClassNameSerializer.java","0","0","0","0","0"
"4","CommonGsonHelper.java","0","0","0","0","0"
"4","DataTypeAdapter.java","0","0","0","0","0"
"4","DatumAdapter.java","83614","332037","415651","127044","31761.0"
"4","GsonHelper.java","0","0","0","0","0"
"4","GsonObject.java","0","0","0","0","0"
"4","GsonSerDerAdapter.java","0","0","0","0","0"
"4","PathSerializer.java","0","0","0","0","0"
"4","TimeZoneGsonSerdeAdapter.java","0","0","0","0","0"
"4","TypeAdapter.java","0","0","0","0","0"
"4","OverridableConf.java","0","0","0","0","0"
"4","QueryId.java","80935","376785","457720","80935","20233.0"
"4","QueryIdFactory.java","0","0","0","0","0"
"4","QueryVars.java","0","0","0","0","0"
"4","BaseRuleProvider.java","0","0","0","0","0"
"4","CheckHadoopRuntimeVersionRule.java","0","0","0","0","0"
"4","TajoConfValidationRule.java","0","0","0","0","0"
"4","EvaluationContext.java","0","0","0","0","0"
"4","EvaluationFailedException.java","0","0","0","0","0"
"4","EvaluationResult.java","0","0","0","0","0"
"4","SelfDiagnosisRule.java","0","0","0","0","0"
"4","SelfDiagnosisRuleDefinition.java","0","0","0","0","0"
"4","SelfDiagnosisRuleEngine.java","0","0","0","0","0"
"4","SelfDiagnosisRuleProvider.java","0","0","0","0","0"
"4","SelfDiagnosisRuleSession.java","0","0","0","0","0"
"4","SelfDiagnosisRuleVisibility.java","0","0","0","0","0"
"4","ANSISQLIdentifierPolicy.java","0","0","0","0","0"
"4","Field.java","0","0","0","0","0"
"4","Identifier.java","0","0","0","0","0"
"4","IdentifierPolicy.java","0","0","0","0","0"
"4","IdentifierUtil.java","0","0","0","0","0"
"4","package-info.java","0","0","0","0","0"
"4","PgSQLIdentifierPolicy.java","0","0","0","0","0"
"4","QualifiedIdentifier.java","0","0","0","0","0"
"4","Schema.java","83578","335331","418909","83578","20894.0"
"4","TajoIdentifierPolicy.java","0","0","0","0","0"
"4","BaseServiceTracker.java","19961","43005","62966","19961","4990.0"
"4","HAServiceTracker.java","19961","43005","62966","19961","4990.0"
"4","ServiceTracker.java","91334","204836","296170","91334","22833.0"
"4","ServiceTrackerException.java","0","0","0","0","0"
"4","ServiceTrackerFactory.java","0","0","0","0","0"
"4","TajoMasterInfo.java","0","0","0","0","0"
"4","SessionVars.java","97039","254041","351080","97039","24259.0"
"4","BufferPool.java","66502","110968","177470","66502","16625.0"
"4","EmptyTuple.java","78262","166673","244935","78262","19565.0"
"4","NullTuple.java","13886","55100","68986","13886","3471.0"
"4","StorageConstants.java","158960","384602","543562","158960","39740.0"
"4","Tuple.java","83614","332037","415651","130455","32613.0"
"4","VTuple.java","83580","334734","418314","130645","32661.0"
"4","TajoConstants.java","84547","420781","505328","84547","21136.0"
"4","TaskAttemptId.java","0","0","0","0","0"
"4","TaskId.java","81370","379915","461285","82703","20675.0"
"4","BaseTupleBuilder.java","7397","11849","19246","7397","1849.0"
"4","CompactRowBlockWriter.java","1906","2605","4511","1906","476.0"
"4","DirectBufTuple.java","120694","228204","348898","120694","30173.0"
"4","FixedSizeLimitSpec.java","0","0","0","0","0"
"4","HeapRowBlockReader.java","0","0","0","0","0"
"4","HeapTuple.java","76797","166919","243716","76797","19199.0"
"4","MemoryBlock.java","0","0","0","0","0"
"4","MemoryRowBlock.java","13995","43228","57223","13995","3498.0"
"4","OffHeapRowBlockReader.java","0","0","0","0","0"
"4","OffHeapRowBlockUtils.java","13995","43228","57223","13995","3498.0"
"4","OffHeapRowBlockWriter.java","120694","228204","348898","120694","30173.0"
"4","OffHeapRowWriter.java","0","0","0","0","0"
"4","ResizableLimitSpec.java","127071","263814","390885","127071","31767.0"
"4","ResizableMemoryBlock.java","15702","45634","61336","15702","3925.0"
"4","RowBlock.java","13995","43228","57223","13995","3498.0"
"4","RowWriter.java","120694","228204","348898","120694","30173.0"
"4","UnSafeTuple.java","76797","166919","243716","76797","19199.0"
"4","UnSafeTupleBytesComparator.java","0","0","0","0","0"
"4","UnSafeTupleList.java","0","0","0","0","0"
"4","ZeroCopyTuple.java","0","0","0","0","0"
"4","RowBlockReader.java","0","0","0","0","0"
"4","TupleBuilder.java","0","0","0","0","0"
"4","Any.java","0","0","0","0","0"
"4","Array.java","0","0","0","0","0"
"4","Bit.java","0","0","0","0","0"
"4","Blob.java","0","0","0","0","0"
"4","Bool.java","0","0","0","0","0"
"4","Char.java","0","0","0","0","0"
"4","Date.java","0","0","0","0","0"
"4","Float4.java","0","0","0","0","0"
"4","Float8.java","0","0","0","0","0"
"4","Int1.java","0","0","0","0","0"
"4","Int2.java","0","0","0","0","0"
"4","Int4.java","0","0","0","0","0"
"4","Int8.java","0","0","0","0","0"
"4","Interval.java","0","0","0","0","0"
"4","Map.java","0","0","0","0","0"
"4","Null.java","0","0","0","0","0"
"4","Numeric.java","0","0","0","0","0"
"4","package-info.java","0","0","0","0","0"
"4","Protobuf.java","0","0","0","0","0"
"4","Record.java","0","0","0","0","0"
"4","Text.java","0","0","0","0","0"
"4","Time.java","0","0","0","0","0"
"4","Timestamp.java","0","0","0","0","0"
"4","Type.java","0","0","0","0","0"
"4","TypeFactory.java","0","0","0","0","0"
"4","TypeParamterizedType.java","0","0","0","0","0"
"4","TypeProtobufEncoder.java","0","0","0","0","0"
"4","TypeStringEncoder.java","0","0","0","0","0"
"4","TypeVisitor.java","0","0","0","0","0"
"4","ValueParamterizedType.java","0","0","0","0","0"
"4","Varchar.java","0","0","0","0","0"
"4","StorageUnit.java","0","0","0","0","0"
"4","TimeUnit.java","0","0","0","0","0"
"4","BasicFuture.java","0","0","0","0","0"
"4","BitArray.java","0","0","0","0","0"
"4","Bytes.java","0","0","0","0","0"
"4","BytesUtils.java","105750","278196","383946","105750","26437.0"
"4","ClassSize.java","0","0","0","0","0"
"4","ClassUtil.java","0","0","0","0","0"
"4","CommonTestingUtil.java","0","0","0","0","0"
"4","CompressionUtil.java","0","0","0","0","0"
"4","DateTimeConstants.java","0","0","0","0","0"
"4","DateTimeFormat.java","0","0","0","0","0"
"4","DateTimeUtil.java","85907","212570","298477","85907","21476.0"
"4","TimeMeta.java","85907","212570","298477","85907","21476.0"
"4","Deallocatable.java","0","0","0","0","0"
"4","FileUtil.java","83603","321083","404686","83603","20900.0"
"4","DirectedGraph.java","0","0","0","0","0"
"4","DirectedGraphCursor.java","0","0","0","0","0"
"4","DirectedGraphVisitor.java","0","0","0","0","0"
"4","Graph.java","0","0","0","0","0"
"4","SimpleDirectedGraph.java","92496","378963","471459","92496","23124.0"
"4","SimpleUndirectedGraph.java","0","0","0","0","0"
"4","UndirectedGraph.java","0","0","0","0","0"
"4","JarUtil.java","0","0","0","0","0"
"4","JavaResourceUtil.java","0","0","0","0","0"
"4","KeyValueSet.java","83566","378721","462287","113105","28276.0"
"4","MurmurHash.java","0","0","0","0","0"
"4","NetUtils.java","0","0","0","0","0"
"4","NumberUtil.java","66583","105360","171943","89414","22353.0"
"4","Pair.java","103326","262115","365441","116462","29115.0"
"4","PlatformUtil.java","0","0","0","0","0"
"4","ProtoUtil.java","0","0","0","0","0"
"4","ReflectionUtil.java","0","0","0","0","0"
"4","ShutdownHookManager.java","0","0","0","0","0"
"4","SizeOf.java","0","0","0","0","0"
"4","StringUtils.java","89626","237639","327265","131940","32985.0"
"4","TajoIdUtils.java","0","0","0","0","0"
"4","TUtil.java","84572","421626","506198","139386","34846.0"
"4","UnsafeComparer.java","0","0","0","0","0"
"4","UnsafeUtil.java","66053","114702","180755","66053","16513.0"
"4","UriUtil.java","0","0","0","0","0"
"4","VersionInfo.java","0","0","0","0","0"
"4","AbstractValidator.java","0","0","0","0","0"
"4","BooleanValidator.java","0","0","0","0","0"
"4","ClassValidator.java","0","0","0","0","0"
"4","ConstraintViolation.java","0","0","0","0","0"
"4","ConstraintViolationException.java","0","0","0","0","0"
"4","GroupValidator.java","0","0","0","0","0"
"4","JavaStringValidator.java","0","0","0","0","0"
"4","LengthValidator.java","0","0","0","0","0"
"4","MaxValidator.java","0","0","0","0","0"
"4","MinValidator.java","0","0","0","0","0"
"4","NetworkAddressValidator.java","0","0","0","0","0"
"4","NotNullValidator.java","0","0","0","0","0"
"4","PathListValidator.java","0","0","0","0","0"
"4","PathValidator.java","0","0","0","0","0"
"4","PatternValidator.java","0","0","0","0","0"
"4","RangeValidator.java","0","0","0","0","0"
"4","ShellVariableValidator.java","0","0","0","0","0"
"4","Validator.java","0","0","0","0","0"
"4","Validators.java","0","0","0","0","0"
"4","TestIPv4.java","0","0","0","0","0"
"4","TestTimeRange.java","0","0","0","0","0"
"4","TestProtobufDatum.java","0","0","0","0","0"
"4","TestTextUtils.java","0","0","0","0","0"
"4","TestArithmeticOperator.java","0","0","0","0","0"
"4","TestBitDatum.java","0","0","0","0","0"
"4","TestBoolDatum.java","0","0","0","0","0"
"4","TestBytesDatum.java","0","0","0","0","0"
"4","TestCharDatum.java","0","0","0","0","0"
"4","TestDateDatum.java","0","0","0","0","0"
"4","TestDatum.java","0","0","0","0","0"
"4","TestDatumFactory.java","0","0","0","0","0"
"4","TestFloat8Datum.java","0","0","0","0","0"
"4","TestFloatDatum.java","0","0","0","0","0"
"4","TestInt2Datum.java","0","0","0","0","0"
"4","TestInt4Datum.java","0","0","0","0","0"
"4","TestInt8Datum.java","0","0","0","0","0"
"4","TestIntervalDatum.java","0","0","0","0","0"
"4","TestTextDatum.java","0","0","0","0","0"
"4","TestTimeDatum.java","0","0","0","0","0"
"4","TestTimestampDatum.java","125529","366025","491554","142611","35652.0"
"4","TestRuleEngine.java","0","0","0","0","0"
"4","TestRuleSession.java","0","0","0","0","0"
"4","TestANSISQLIdentifierPolicy.java","0","0","0","0","0"
"4","TestIdentifier.java","0","0","0","0","0"
"4","TestSchema.java","82779","315961","398740","82779","20694.0"
"4","TestTajoIdentifierPolicy.java","0","0","0","0","0"
"4","TestHeapTuple.java","0","0","0","0","0"
"4","TestMemoryRowBlock.java","120694","228204","348898","120694","30173.0"
"4","TestResizableSpec.java","0","0","0","0","0"
"4","TestUnSafeTupleBytesComparator.java","0","0","0","0","0"
"4","TestBaseTupleBuilder.java","0","0","0","0","0"
"4","TestType.java","0","0","0","0","0"
"4","TestTypeEncoder.java","0","0","0","0","0"
"4","TestTypeProtobufEncoder.java","0","0","0","0","0"
"4","TestTypeStringEncoder.java","0","0","0","0","0"
"4","TestSimpleDirectedGraph.java","92060","377794","469854","99626","24906.0"
"4","TestSimpleUndirectedGraph.java","0","0","0","0","0"
"4","TestBitArrayTest.java","0","0","0","0","0"
"4","TestDateTimeFormat.java","0","0","0","0","0"
"4","TestDateTimeUtil.java","0","0","0","0","0"
"4","TestNumberUtil.java","0","0","0","0","0"
"4","TestStringUtil.java","0","0","0","0","0"
"4","TestUriUtil.java","0","0","0","0","0"
"4","TestValidators.java","124922","267769","392691","124922","31230.0"
"4","BenchmarkSet.java","84320","393358","477678","113977","28494.0"
"4","Driver.java","0","0","0","0","0"
"4","SimpleQuery.java","0","0","0","0","0"
"4","TPCH.java","83983","380705","464688","119650","29912.0"
"4","CaseWhenEmitter.java","0","0","0","0","0"
"4","CaseWhenSwitchGenerator.java","0","0","0","0","0"
"4","CodeGenUtils.java","0","0","0","0","0"
"4","CompilationError.java","0","0","0","0","0"
"4","EvalCodeEmitter.java","0","0","0","0","0"
"4","EvalCodeGenContext.java","0","0","0","0","0"
"4","EvalCodeGenerator.java","89742","138887","228629","89742","22435.0"
"4","ExecutorPreCompiler.java","85037","186115","271152","85037","21259.0"
"4","LegacyFunctionBindingEmitter.java","0","0","0","0","0"
"4","ScalarFunctionBindingEmitter.java","0","0","0","0","0"
"4","TajoClassLoader.java","0","0","0","0","0"
"4","TajoGeneratorAdapter.java","0","0","0","0","0"
"4","VariablesPreBuilder.java","0","0","0","0","0"
"4","RangeOverflowException.java","0","0","0","0","0"
"4","Description.java","0","0","0","0","0"
"4","ParamOptionTypes.java","0","0","0","0","0"
"4","ParamTypes.java","0","0","0","0","0"
"4","AvgDouble.java","83566","375934","459500","96264","24066.0"
"4","AvgFloat.java","134817","358041","492858","134817","33704.0"
"4","AvgInt.java","134817","358041","492858","134817","33704.0"
"4","AvgLong.java","83566","375934","459500","96264","24066.0"
"4","Coalesce.java","0","0","0","0","0"
"4","CoalesceBoolean.java","0","0","0","0","0"
"4","CoalesceDate.java","0","0","0","0","0"
"4","CoalesceDouble.java","0","0","0","0","0"
"4","CoalesceLong.java","0","0","0","0","0"
"4","CoalesceString.java","0","0","0","0","0"
"4","CoalesceTime.java","0","0","0","0","0"
"4","CoalesceTimestamp.java","0","0","0","0","0"
"4","Corr.java","0","0","0","0","0"
"4","CountRows.java","0","0","0","0","0"
"4","CountValue.java","0","0","0","0","0"
"4","CountValueDistinct.java","92828","372989","465817","92828","23207.0"
"4","Date.java","0","0","0","0","0"
"4","LastValue.java","0","0","0","0","0"
"4","LastValueDate.java","0","0","0","0","0"
"4","LastValueDouble.java","0","0","0","0","0"
"4","LastValueFloat.java","0","0","0","0","0"
"4","LastValueInt.java","0","0","0","0","0"
"4","LastValueLong.java","0","0","0","0","0"
"4","LastValueString.java","0","0","0","0","0"
"4","LastValueTime.java","0","0","0","0","0"
"4","LastValueTimestamp.java","0","0","0","0","0"
"4","Lead.java","100026","202719","302745","100026","25006.0"
"4","LeadDate.java","0","0","0","0","0"
"4","LeadDouble.java","0","0","0","0","0"
"4","LeadFloat.java","0","0","0","0","0"
"4","LeadInt.java","0","0","0","0","0"
"4","LeadLong.java","0","0","0","0","0"
"4","LeadString.java","0","0","0","0","0"
"4","LeadTime.java","0","0","0","0","0"
"4","LeadTimestamp.java","0","0","0","0","0"
"4","Max.java","0","0","0","0","0"
"4","MaxDate.java","0","0","0","0","0"
"4","MaxDouble.java","0","0","0","0","0"
"4","MaxFloat.java","0","0","0","0","0"
"4","MaxInt.java","0","0","0","0","0"
"4","MaxLong.java","0","0","0","0","0"
"4","MaxString.java","0","0","0","0","0"
"4","MaxTime.java","0","0","0","0","0"
"4","MaxTimestamp.java","0","0","0","0","0"
"4","Min.java","0","0","0","0","0"
"4","MinDate.java","0","0","0","0","0"
"4","MinDouble.java","0","0","0","0","0"
"4","MinFloat.java","0","0","0","0","0"
"4","MinInt.java","0","0","0","0","0"
"4","MinLong.java","0","0","0","0","0"
"4","MinString.java","0","0","0","0","0"
"4","MinTime.java","0","0","0","0","0"
"4","MinTimestamp.java","0","0","0","0","0"
"4","RandomInt.java","0","0","0","0","0"
"4","Sleep.java","0","0","0","0","0"
"4","StdDevPop.java","7313","12999","20312","7313","1828.0"
"4","StdDevPopDouble.java","0","0","0","0","0"
"4","StdDevPopFloat.java","0","0","0","0","0"
"4","StdDevPopInt.java","0","0","0","0","0"
"4","StdDevPopLong.java","0","0","0","0","0"
"4","StdDevSamp.java","7313","12999","20312","7313","1828.0"
"4","StdDevSampDouble.java","0","0","0","0","0"
"4","StdDevSampFloat.java","0","0","0","0","0"
"4","StdDevSampInt.java","0","0","0","0","0"
"4","StdDevSampLong.java","0","0","0","0","0"
"4","StringAgg.java","0","0","0","0","0"
"4","SumDouble.java","0","0","0","0","0"
"4","SumDoubleDistinct.java","0","0","0","0","0"
"4","SumFloat.java","0","0","0","0","0"
"4","SumFloatDistinct.java","0","0","0","0","0"
"4","SumInt.java","0","0","0","0","0"
"4","SumIntDistinct.java","0","0","0","0","0"
"4","SumLong.java","0","0","0","0","0"
"4","SumLongDistinct.java","0","0","0","0","0"
"4","Variance.java","0","0","0","0","0"
"4","VarPop.java","0","0","0","0","0"
"4","VarPopDouble.java","0","0","0","0","0"
"4","VarPopFloat.java","0","0","0","0","0"
"4","VarPopInt.java","0","0","0","0","0"
"4","VarPopLong.java","0","0","0","0","0"
"4","VarSamp.java","0","0","0","0","0"
"4","VarSampDouble.java","0","0","0","0","0"
"4","VarSampFloat.java","0","0","0","0","0"
"4","VarSampInt.java","0","0","0","0","0"
"4","VarSampLong.java","0","0","0","0","0"
"4","AddDays.java","0","0","0","0","0"
"4","AddMonths.java","0","0","0","0","0"
"4","CurrentDate.java","0","0","0","0","0"
"4","CurrentTime.java","0","0","0","0","0"
"4","DatePartFromDate.java","136406","358031","494437","136406","34101.0"
"4","DatePartFromTime.java","0","0","0","0","0"
"4","DatePartFromTimestamp.java","0","0","0","0","0"
"4","DateTimePartFromUnixTimestamp.java","147434","350231","497665","147434","36858.0"
"4","NowTimestamp.java","0","0","0","0","0"
"4","ToCharTimestamp.java","125529","366025","491554","130637","32659.0"
"4","ToDate.java","84600","225198","309798","84600","21150.0"
"4","ToTimestampInt.java","0","0","0","0","0"
"4","ToTimestampText.java","0","0","0","0","0"
"4","FailFunction.java","0","0","0","0","0"
"4","FunctionLoader.java","92487","142115","234602","92487","23121.0"
"4","BlobToIPstr.java","0","0","0","0","0"
"4","GeoIPCountryBlob.java","0","0","0","0","0"
"4","GeoIPCountryInt.java","0","0","0","0","0"
"4","GeoIPCountryText.java","0","0","0","0","0"
"4","GeoIPInCountryBlob.java","0","0","0","0","0"
"4","GeoIPInCountryInt.java","0","0","0","0","0"
"4","GeoIPInCountryText.java","144213","354057","498270","144213","36053.0"
"4","IntToIPstr.java","0","0","0","0","0"
"4","IPstrToBlob.java","0","0","0","0","0"
"4","IPstrToInt.java","0","0","0","0","0"
"4","HiveFunctionLoader.java","0","0","0","0","0"
"4","JsonArrayContains.java","0","0","0","0","0"
"4","JsonArrayGet.java","0","0","0","0","0"
"4","JsonArrayLength.java","0","0","0","0","0"
"4","JsonExtractPathText.java","0","0","0","0","0"
"4","ScalarJsonFunction.java","0","0","0","0","0"
"4","AbsDouble.java","0","0","0","0","0"
"4","AbsFloat.java","0","0","0","0","0"
"4","AbsInt.java","0","0","0","0","0"
"4","AbsLong.java","0","0","0","0","0"
"4","Acos.java","0","0","0","0","0"
"4","Asin.java","0","0","0","0","0"
"4","Atan.java","0","0","0","0","0"
"4","Atan2.java","0","0","0","0","0"
"4","Cbrt.java","0","0","0","0","0"
"4","Ceil.java","0","0","0","0","0"
"4","Cos.java","0","0","0","0","0"
"4","Degrees.java","0","0","0","0","0"
"4","Div.java","122913","366311","489224","122913","30728.0"
"4","Exp.java","0","0","0","0","0"
"4","Floor.java","0","0","0","0","0"
"4","MathFunctions.java","0","0","0","0","0"
"4","Mod.java","122913","366311","489224","122913","30728.0"
"4","Pi.java","0","0","0","0","0"
"4","Pow.java","0","0","0","0","0"
"4","Radians.java","0","0","0","0","0"
"4","Round.java","0","0","0","0","0"
"4","RoundFloat8.java","93291","277705","370996","93291","23322.0"
"4","Sign.java","0","0","0","0","0"
"4","Sin.java","0","0","0","0","0"
"4","Sqrt.java","0","0","0","0","0"
"4","Tan.java","0","0","0","0","0"
"4","Ascii.java","122457","366311","488768","122457","30614.0"
"4","BitLength.java","118277","366469","484746","118277","29569.0"
"4","BTrim.java","101613","370152","471765","130637","32659.0"
"4","CharLength.java","113915","369562","483477","113915","28478.0"
"4","Chr.java","125108","366188","491296","125108","31277.0"
"4","Concat.java","149520","349931","499451","149520","37380.0"
"4","Concat_ws.java","149609","349931","499540","149609","37402.0"
"4","Decode.java","130820","365207","496027","130820","32705.0"
"4","Digest.java","134921","358041","492962","134921","33730.0"
"4","Encode.java","130820","365207","496027","130820","32705.0"
"4","FindInSet.java","130842","364340","495182","130842","32710.0"
"4","HexStringConverter.java","0","0","0","0","0"
"4","InitCap.java","121911","366311","488222","121911","30477.0"
"4","Left.java","119990","366462","486452","119990","29997.0"
"4","Length.java","0","0","0","0","0"
"4","Locate.java","123701","366301","490002","123701","30925.0"
"4","Lower.java","0","0","0","0","0"
"4","Lpad.java","122611","366311","488922","131789","32947.0"
"4","LTrim.java","101613","370152","471765","130637","32659.0"
"4","Md5.java","118960","366467","485427","118960","29740.0"
"4","OctetLength.java","0","0","0","0","0"
"4","QuoteIdent.java","0","0","0","0","0"
"4","RegexpReplace.java","93265","372921","466186","130637","32659.0"
"4","Repeat.java","120224","366462","486686","120224","30056.0"
"4","Reverse.java","118885","366467","485352","118885","29721.0"
"4","Right.java","119990","366462","486452","119990","29997.0"
"4","Rpad.java","122705","366311","489016","131789","32947.0"
"4","RTrim.java","101613","370152","471765","130637","32659.0"
"4","SplitPart.java","92866","373201","466067","92866","23216.0"
"4","StrPos.java","118818","366467","485285","118818","29704.0"
"4","StrPosb.java","118818","366467","485285","118818","29704.0"
"4","Substr.java","118214","366469","484683","118214","29553.0"
"4","ToBin.java","0","0","0","0","0"
"4","ToCharLong.java","0","0","0","0","0"
"4","ToHex.java","0","0","0","0","0"
"4","Upper.java","101185","370152","471337","101185","25296.0"
"4","FirstValue.java","49946","118111","168057","49946","12486.0"
"4","FirstValueDate.java","0","0","0","0","0"
"4","FirstValueDouble.java","0","0","0","0","0"
"4","FirstValueFloat.java","0","0","0","0","0"
"4","FirstValueInt.java","0","0","0","0","0"
"4","FirstValueLong.java","0","0","0","0","0"
"4","FirstValueString.java","0","0","0","0","0"
"4","FirstValueTime.java","0","0","0","0","0"
"4","FirstValueTimestamp.java","0","0","0","0","0"
"4","Lag.java","34400","96788","131188","34400","8600.0"
"4","LagDate.java","0","0","0","0","0"
"4","LagDouble.java","0","0","0","0","0"
"4","LagFloat.java","0","0","0","0","0"
"4","LagInt.java","0","0","0","0","0"
"4","LagLong.java","0","0","0","0","0"
"4","LagString.java","0","0","0","0","0"
"4","LagTime.java","0","0","0","0","0"
"4","LagTimestamp.java","0","0","0","0","0"
"4","Rank.java","0","0","0","0","0"
"4","RowNumber.java","0","0","0","0","0"
"4","CoreGsonHelper.java","0","0","0","0","0"
"4","Enforcer.java","92265","375743","468008","112800","28200.0"
"4","DistinctGroupbyBuilder.java","128510","349755","478265","128510","32127.0"
"4","DataChannel.java","92070","332718","424788","126775","31693.0"
"4","ExecutionBlock.java","83580","375555","459135","126082","31520.0"
"4","ExecutionBlockCursor.java","83580","375832","459412","91066","22766.0"
"4","ExecutionQueue.java","0","0","0","0","0"
"4","GlobalPlanner.java","83594","319606","403200","136912","34228.0"
"4","MasterPlan.java","92072","372942","465014","123816","30954.0"
"4","ParallelExecutionQueue.java","127186","171988","299174","127186","31796.0"
"4","BaseGlobalPlanRewriteRuleProvider.java","47050","111962","159012","47050","11762.0"
"4","GlobalPlanRewriteEngine.java","110986","221786","332772","110986","27746.0"
"4","GlobalPlanRewriteRule.java","0","0","0","0","0"
"4","GlobalPlanRewriteRuleProvider.java","0","0","0","0","0"
"4","GlobalPlanTestRuleProvider.java","0","0","0","0","0"
"4","BroadcastJoinRule.java","116525","133066","249591","116525","29131.0"
"4","GlobalPlanEqualityTester.java","0","0","0","0","0"
"4","GlobalPlanRewriteUtil.java","0","0","0","0","0"
"4","KeyProjector.java","0","0","0","0","0"
"4","AggregationExec.java","134828","302594","437422","134828","33707.0"
"4","BasicPhysicalExecutorVisitor.java","92755","391124","483879","92755","23188.0"
"4","BinaryPhysicalExec.java","0","0","0","0","0"
"4","BSTIndexScanExec.java","83604","321848","405452","83604","20901.0"
"4","ColPartitionStoreExec.java","137231","366971","504202","137231","34307.0"
"4","CommonHashJoinExec.java","31147","77687","108834","31147","7786.0"
"4","CommonJoinExec.java","10213","23123","33336","10213","2553.0"
"4","ComparableVector.java","1299","6754","8053","1299","324.0"
"4","DistinctGroupbyFirstAggregationExec.java","90094","132551","222645","90094","22523.0"
"4","DistinctGroupbyHashAggregationExec.java","85408","212224","297632","85408","21352.0"
"4","DistinctGroupbySecondAggregationExec.java","111591","213498","325089","111591","27897.0"
"4","DistinctGroupbySortAggregationExec.java","129074","355494","484568","129074","32268.0"
"4","DistinctGroupbyThirdAggregationExec.java","101974","198162","300136","101974","25493.0"
"4","EmptyScanIterator.java","0","0","0","0","0"
"4","EvalExprExec.java","83614","332037","415651","113432","28358.0"
"4","ExternalSortExec.java","136610","301473","438083","136610","34152.0"
"4","FilterScanIterator.java","0","0","0","0","0"
"4","FullScanIterator.java","0","0","0","0","0"
"4","HashAggregateExec.java","83983","381677","465660","128475","32118.0"
"4","HashBasedColPartitionStoreExec.java","137127","363311","500438","137127","34281.0"
"4","HashFullOuterJoinExec.java","97507","331556","429063","129292","32323.0"
"4","HashJoinExec.java","83580","334734","418314","83580","20895.0"
"4","HashLeftAntiJoinExec.java","79733","332674","412407","79733","19933.0"
"4","HashLeftOuterJoinExec.java","96620","313018","409638","96620","24155.0"
"4","HashLeftSemiJoinExec.java","80054","332674","412728","100645","25161.0"
"4","HashPartitioner.java","0","0","0","0","0"
"4","HashShuffleFileWriteExec.java","84576","423565","508141","138616","34654.0"
"4","HavingExec.java","132757","303075","435832","132757","33189.0"
"4","IndexExecutorUtil.java","0","0","0","0","0"
"4","InsertRowsExec.java","0","0","0","0","0"
"4","JoinTupleComparator.java","0","0","0","0","0"
"4","KeyTuple.java","2685","2841","5526","2685","671.0"
"4","LimitExec.java","0","0","0","0","0"
"4","MergeFullOuterJoinExec.java","97511","318650","416161","97511","24377.0"
"4","MergeJoinExec.java","83604","321848","405452","83604","20901.0"
"4","Partitioner.java","0","0","0","0","0"
"4","PartitionMergeScanExec.java","134720","294113","428833","134720","33680.0"
"4","PhysicalExec.java","0","0","0","0","0"
"4","PhysicalExecutorVisitor.java","0","0","0","0","0"
"4","PhysicalPlanUtil.java","73663","164974","238637","129726","32431.0"
"4","ProjectionExec.java","0","0","0","0","0"
"4","RadixSort.java","0","0","0","0","0"
"4","RangeShuffleFileWriteExec.java","83983","381677","465660","134647","33661.0"
"4","RightOuterMergeJoinExec.java","97507","331556","429063","110815","27703.0"
"4","ScanExec.java","0","0","0","0","0"
"4","ScanIterator.java","0","0","0","0","0"
"4","SelectionExec.java","83604","321848","405452","83604","20901.0"
"4","SeqScanExec.java","82779","316282","399061","148070","37017.0"
"4","SetTupleComparator.java","0","0","0","0","0"
"4","SortAggregateExec.java","83983","381677","465660","128475","32118.0"
"4","SortBasedColPartitionStoreExec.java","137127","363311","500438","137127","34281.0"
"4","SortExec.java","83603","320421","404024","83603","20900.0"
"4","SortIntersectExec.java","0","0","0","0","0"
"4","StoreIndexExec.java","99780","108724","208504","99780","24945.0"
"4","StoreTableExec.java","83566","379726","463292","134647","33661.0"
"4","TunnelExec.java","0","0","0","0","0"
"4","TupleList.java","0","0","0","0","0"
"4","TupleMap.java","0","0","0","0","0"
"4","TupleSet.java","0","0","0","0","0"
"4","TupleSorter.java","2320","3992","6312","2320","580.0"
"4","UnaryPhysicalExec.java","0","0","0","0","0"
"4","UnionExec.java","0","0","0","0","0"
"4","VectorizedSorter.java","2320","3992","6312","2320","580.0"
"4","WindowAggExec.java","84074","196667","280741","84074","21018.0"
"4","PhysicalPlanner.java","0","0","0","0","0"
"4","PhysicalPlannerImpl.java","83622","332563","416185","137153","34288.0"
"4","PhysicalPlanningException.java","0","0","0","0","0"
"4","Projector.java","83604","321848","405452","128255","32063.0"
"4","RangePartitionAlgorithm.java","83566","375934","459500","127783","31945.0"
"4","UniformRangePartition.java","83566","375934","459500","117218","29304.0"
"4","QueryContext.java","81787","377429","459216","127464","31866.0"
"4","TaskRequest.java","0","0","0","0","0"
"4","TaskRequestImpl.java","83572","378498","462070","91258","22814.0"
"4","CacheHolder.java","15320","32971","48291","15320","3830.0"
"4","TableCache.java","0","0","0","0","0"
"4","TableCacheKey.java","0","0","0","0","0"
"4","ErrorInjectionRewriter.java","0","0","0","0","0"
"4","TupleUtil.java","84587","423733","508320","138954","34738.0"
"4","HdfsServiceTracker.java","19961","43005","62966","19961","4990.0"
"4","AsyncTaskService.java","0","0","0","0","0"
"4","WorkerConnectionInfo.java","0","0","0","0","0"
"4","FragmentScheduleEvent.java","0","0","0","0","0"
"4","LocalTaskEvent.java","140321","359411","499732","140321","35080.0"
"4","LocalTaskEventType.java","0","0","0","0","0"
"4","QueryCompletedEvent.java","0","0","0","0","0"
"4","QueryDiagnosticsUpdateEvent.java","0","0","0","0","0"
"4","QueryEvent.java","0","0","0","0","0"
"4","QueryEventType.java","0","0","0","0","0"
"4","QueryMasterQueryCompletedEvent.java","0","0","0","0","0"
"4","QueryStartEvent.java","147482","353416","500898","147482","36870.0"
"4","QueryStopEvent.java","108386","212992","321378","108386","27096.0"
"4","StageCompletedEvent.java","0","0","0","0","0"
"4","StageDiagnosticsUpdateEvent.java","0","0","0","0","0"
"4","StageEvent.java","0","0","0","0","0"
"4","StageEventType.java","0","0","0","0","0"
"4","StageShuffleReportEvent.java","0","0","0","0","0"
"4","StageTaskEvent.java","0","0","0","0","0"
"4","StageTaskFailedEvent.java","0","0","0","0","0"
"4","TaskAttemptAssignedEvent.java","0","0","0","0","0"
"4","TaskAttemptEvent.java","0","0","0","0","0"
"4","TaskAttemptEventType.java","0","0","0","0","0"
"4","TaskAttemptScheduleEvent.java","0","0","0","0","0"
"4","TaskAttemptStatusUpdateEvent.java","0","0","0","0","0"
"4","TaskAttemptToSchedulerEvent.java","0","0","0","0","0"
"4","TaskCompletionEvent.java","0","0","0","0","0"
"4","TaskEvent.java","0","0","0","0","0"
"4","TaskEventType.java","0","0","0","0","0"
"4","TaskFatalErrorEvent.java","0","0","0","0","0"
"4","TaskRequestEvent.java","0","0","0","0","0"
"4","TaskSchedulerEvent.java","0","0","0","0","0"
"4","TaskTAttemptEvent.java","0","0","0","0","0"
"4","TaskTAttemptFailedEvent.java","0","0","0","0","0"
"4","CreateTableExecutor.java","3861","7590","11451","3861","965.0"
"4","DDLExecutor.java","31951","46704","78655","31951","7987.0"
"4","ExplainGlobalPlanPreprocessorForTest.java","0","0","0","0","0"
"4","ExplainPlanPreprocessorForTest.java","20936","71145","92081","20936","5234.0"
"4","NonForwardQueryResultFileScanner.java","29489","43630","73119","29489","7372.0"
"4","NonForwardQueryResultScanner.java","146767","269351","416118","146767","36691.0"
"4","NonForwardQueryResultSystemScanner.java","26822","35467","62289","26822","6705.0"
"4","CreateTableHook.java","54138","126057","180195","54138","13534.0"
"4","DistributedQueryHook.java","0","0","0","0","0"
"4","DistributedQueryHookManager.java","0","0","0","0","0"
"4","InsertIntoHook.java","0","0","0","0","0"
"4","QueryExecutor.java","29079","42318","71397","29079","7269.0"
"4","GlobalEngine.java","85250","220715","305965","120441","30110.0"
"4","QueryCoordinatorService.java","80948","376569","457517","120607","30151.0"
"4","QueryInfo.java","0","0","0","0","0"
"4","QueryInProgress.java","80959","318103","399062","141894","35473.0"
"4","QueryManager.java","80959","318103","399062","112789","28197.0"
"4","NodeEvent.java","142109","358708","500817","142109","35527.0"
"4","NodeEventType.java","0","0","0","0","0"
"4","NodeLivelinessMonitor.java","142109","358708","500817","142109","35527.0"
"4","NodeReconnectEvent.java","142109","358708","500817","142109","35527.0"
"4","NodeState.java","142109","358708","500817","142109","35527.0"
"4","NodeStatus.java","0","0","0","0","0"
"4","NodeStatusEvent.java","0","0","0","0","0"
"4","TajoResourceManager.java","0","0","0","0","0"
"4","TajoResourceTracker.java","140329","306888","447217","140329","35082.0"
"4","TajoRMContext.java","142109","358708","500817","142109","35527.0"
"4","WorkerResource.java","80949","373896","454845","80949","20237.0"
"4","FileSystemRule.java","0","0","0","0","0"
"4","MasterRuleProvider.java","0","0","0","0","0"
"4","AbstractQueryScheduler.java","0","0","0","0","0"
"4","ResourceReserveSchedulerEvent.java","0","0","0","0","0"
"4","SchedulerEvent.java","0","0","0","0","0"
"4","SchedulerEventType.java","0","0","0","0","0"
"4","QuerySchedulingInfo.java","99110","282161","381271","99110","24777.0"
"4","QueueInfo.java","0","0","0","0","0"
"4","QueueState.java","0","0","0","0","0"
"4","Scheduler.java","0","0","0","0","0"
"4","SchedulingAlgorithms.java","99110","282161","381271","99110","24777.0"
"4","SimpleScheduler.java","0","0","0","0","0"
"4","TajoResourceScheduler.java","0","0","0","0","0"
"4","TajoMaster.java","83604","327469","411073","141658","35414.0"
"4","TajoMasterClientService.java","83566","378731","462297","144744","36186.0"
"4","TaskState.java","0","0","0","0","0"
"4","ClusterResourceMetricSet.java","0","0","0","0","0"
"4","SQLAnalyzer.java","75880","314351","390231","152241","38060.0"
"4","SQLErrorListener.java","76524","396039","472563","76524","19131.0"
"4","SQLParseError.java","76524","396039","472563","76524","19131.0"
"4","AbstractTaskScheduler.java","83572","378498","462070","83572","20893.0"
"4","DefaultTaskScheduler.java","83572","378498","462070","148870","37217.0"
"4","FetchScheduleEvent.java","0","0","0","0","0"
"4","Query.java","83580","375832","459412","141883","35470.0"
"4","QueryJobEvent.java","0","0","0","0","0"
"4","QueryMaster.java","77205","376994","454199","149319","37329.0"
"4","QueryMasterManagerService.java","114754","327621","442375","124696","31174.0"
"4","QueryMasterTask.java","80969","320240","401209","148619","37154.0"
"4","Repartitioner.java","83580","375555","459135","148834","37208.0"
"4","Stage.java","28235","39860","68095","28235","7058.0"
"4","StageState.java","0","0","0","0","0"
"4","Task.java","83566","378764","462330","151570","37892.0"
"4","TaskAttempt.java","83572","378498","462070","148834","37208.0"
"4","TaskSchedulerContext.java","0","0","0","0","0"
"4","TaskSchedulerFactory.java","0","0","0","0","0"
"4","DefaultResourceCalculator.java","0","0","0","0","0"
"4","NodeResource.java","0","0","0","0","0"
"4","NodeResources.java","0","0","0","0","0"
"4","ResourceCalculator.java","0","0","0","0","0"
"4","NoSuchSessionVariableException.java","83983","380705","464688","83983","20995.0"
"4","Session.java","145048","301041","446089","145048","36262.0"
"4","SessionConstants.java","0","0","0","0","0"
"4","SessionEvent.java","0","0","0","0","0"
"4","SessionEventType.java","0","0","0","0","0"
"4","SessionLivelinessMonitor.java","0","0","0","0","0"
"4","SessionManager.java","148438","356386","504824","148438","37109.0"
"4","ApplicationIdUtils.java","0","0","0","0","0"
"4","GeoIPUtil.java","0","0","0","0","0"
"4","History.java","0","0","0","0","0"
"4","HistoryCleaner.java","0","0","0","0","0"
"4","HistoryReader.java","89762","180485","270247","89762","22440.0"
"4","HistoryWriter.java","67688","108974","176662","67688","16922.0"
"4","QueryHistory.java","0","0","0","0","0"
"4","StageHistory.java","0","0","0","0","0"
"4","TaskHistory.java","86231","173935","260166","138349","34587.0"
"4","IPconvertUtil.java","0","0","0","0","0"
"4","JSPUtil.java","92899","375560","468459","138429","34607.0"
"4","JvmPauseMonitor.java","0","0","0","0","0"
"4","GroupNameMetricsFilter.java","0","0","0","0","0"
"4","LogEventGaugeSet.java","0","0","0","0","0"
"4","MetricsFilterList.java","0","0","0","0","0"
"4","RegexpMetricsFilter.java","0","0","0","0","0"
"4","GangliaReporter.java","0","0","0","0","0"
"4","MetricsConsoleReporter.java","0","0","0","0","0"
"4","MetricsConsoleScheduledReporter.java","0","0","0","0","0"
"4","MetricsFileScheduledReporter.java","0","0","0","0","0"
"4","MetricsStreamScheduledReporter.java","0","0","0","0","0"
"4","NullReporter.java","0","0","0","0","0"
"4","TajoMetricsReporter.java","129232","370379","499611","129232","32308.0"
"4","TajoMetricsScheduledReporter.java","0","0","0","0","0"
"4","TajoJMXObjectNameFactory.java","0","0","0","0","0"
"4","TajoLogEventCounter.java","0","0","0","0","0"
"4","TajoMetrics.java","129236","370559","499795","129236","32309.0"
"4","TajoSystemMetrics.java","129236","370559","499795","129236","32309.0"
"4","RpcParameterFactory.java","0","0","0","0","0"
"4","SplitUtil.java","0","0","0","0","0"
"4","TajoUncaughtExceptionHandler.java","0","0","0","0","0"
"4","TimeZoneUtil.java","0","0","0","0","0"
"4","HttpServer.java","84547","417220","501767","84547","21136.0"
"4","QueryExecutorServlet.java","114604","374499","489103","120088","30022.0"
"4","StaticHttpServer.java","0","0","0","0","0"
"4","AbstractFetcher.java","0","0","0","0","0"
"4","DeletionService.java","0","0","0","0","0"
"4","ExecutionBlockErrorEvent.java","108386","212992","321378","108386","27096.0"
"4","ExecutionBlockStopEvent.java","7998","13700","21698","7998","1999.0"
"4","NodeResourceAllocateEvent.java","24071","29501","53572","24071","6017.0"
"4","NodeResourceDeallocateEvent.java","24071","29501","53572","24071","6017.0"
"4","NodeResourceEvent.java","18376","18104","36480","18376","4594.0"
"4","NodeStatusEvent.java","0","0","0","0","0"
"4","QMResourceAllocateEvent.java","0","0","0","0","0"
"4","QueryStopEvent.java","108386","212992","321378","108386","27096.0"
"4","TaskManagerEvent.java","0","0","0","0","0"
"4","TaskStartEvent.java","18376","18104","36480","18376","4594.0"
"4","ExecutionBlockContext.java","85487","128741","214228","85487","21371.0"
"4","ExecutionBlockSharedResource.java","85535","129939","215474","85535","21383.0"
"4","FetchImpl.java","97393","287690","385083","97393","24348.0"
"4","LocalFetcher.java","0","0","0","0","0"
"4","NodeResourceManager.java","7998","13700","21698","7998","1999.0"
"4","NodeStatusUpdater.java","7998","13700","21698","7998","1999.0"
"4","RemoteFetcher.java","83614","332024","415638","126752","31688.0"
"4","ConnectivityCheckerRuleForTajoWorker.java","128612","246199","374811","128612","32153.0"
"4","WorkerRuleProvider.java","0","0","0","0","0"
"4","TajoQueryEngine.java","0","0","0","0","0"
"4","TajoWorker.java","80973","319819","400792","134940","33735.0"
"4","TajoWorkerClientService.java","77624","379209","456833","120735","30183.0"
"4","TajoWorkerManagerService.java","80948","376569","457517","119948","29987.0"
"4","Task.java","83566","378764","462330","151570","37892.0"
"4","TaskAttemptContext.java","83566","378764","462330","148600","37150.0"
"4","TaskContainer.java","0","0","0","0","0"
"4","TaskExecutor.java","18376","18104","36480","18376","4594.0"
"4","TaskHistory.java","86231","173935","260166","138349","34587.0"
"4","TaskImpl.java","18376","18104","36480","18376","4594.0"
"4","TaskManager.java","18376","18104","36480","18376","4594.0"
"4","RestReturnType.java","0","0","0","0","0"
"4","ClientApplication.java","10959","18318","29277","10959","2739.0"
"4","JerseyResourceDelegate.java","0","0","0","0","0"
"4","JerseyResourceDelegateContext.java","0","0","0","0","0"
"4","JerseyResourceDelegateContextKey.java","0","0","0","0","0"
"4","JerseyResourceDelegateUtil.java","0","0","0","0","0"
"4","NewDatabaseRequest.java","0","0","0","0","0"
"4","NewSessionRequest.java","0","0","0","0","0"
"4","SubmitQueryRequest.java","0","0","0","0","0"
"4","ClusterResource.java","35483","86544","122027","35483","8870.0"
"4","DatabasesResource.java","5770","11966","17736","5770","1442.0"
"4","FunctionsResource.java","24865","76158","101023","24865","6216.0"
"4","AbstractStreamingOutput.java","0","0","0","0","0"
"4","BinaryStreamingOutput.java","0","0","0","0","0"
"4","CSVStreamingOutput.java","0","0","0","0","0"
"4","RestOutputFactory.java","0","0","0","0","0"
"4","QueryResource.java","21796","69980","91776","21796","5449.0"
"4","QueryResultResource.java","27107","79829","106936","27107","6776.0"
"4","SessionsResource.java","0","0","0","0","0"
"4","TablesResource.java","27128","79851","106979","27128","6782.0"
"4","ResourcesUtil.java","0","0","0","0","0"
"4","DatabaseInfoResponse.java","0","0","0","0","0"
"4","ExceptionResponse.java","0","0","0","0","0"
"4","GetQueryResultDataResponse.java","0","0","0","0","0"
"4","GetSubmitQueryResponse.java","0","0","0","0","0"
"4","NewSessionResponse.java","0","0","0","0","0"
"4","ResultSetInfoResponse.java","0","0","0","0","0"
"4","WorkerConnectionInfoResponse.java","0","0","0","0","0"
"4","WorkerResponse.java","5770","11966","17736","5770","1442.0"
"4","TajoRestService.java","0","0","0","0","0"
"4","TestTPCH.java","83580","375555","459135","83580","20895.0"
"4","TestDDLBuilder.java","101626","409356","510982","101626","25406.0"
"4","TestTajoDump.java","151659","282708","434367","151659","37914.0"
"4","TestExecExternalShellCommand.java","0","0","0","0","0"
"4","TestHdfsCommand.java","0","0","0","0","0"
"4","TestDefaultCliOutputFormatter.java","86820","234640","321460","86820","21705.0"
"4","TestSimpleParser.java","146576","306227","452803","146576","36644.0"
"4","TestTajoCli.java","80400","209195","289595","80866","20216.0"
"4","TestTajoCliNegatives.java","109654","140944","250598","109654","27413.0"
"4","TestCatalogAdminClientExceptions.java","0","0","0","0","0"
"4","TestQueryClientExceptions.java","106912","116183","223095","106912","26728.0"
"4","TestTajoClient.java","135714","362121","497835","135714","33928.0"
"4","TestTajoClientV2.java","3446","5585","9031","3446","861.0"
"4","TestWorkerConnectionInfo.java","0","0","0","0","0"
"4","TestEvalCodeGenerator.java","0","0","0","0","0"
"4","TestGeneratorAdapter.java","0","0","0","0","0"
"4","ExprTestBase.java","92818","329295","422113","141361","35340.0"
"4","TestEvalTree.java","83604","321848","405452","127786","31946.0"
"4","TestEvalTreeUtil.java","83614","332037","415651","129692","32423.0"
"4","TestIntervalType.java","0","0","0","0","0"
"4","TestPredicates.java","0","0","0","0","0"
"4","TestSQLDateTimeTypes.java","0","0","0","0","0"
"4","TestSQLExpression.java","101952","286549","388501","127148","31787.0"
"4","HiveUDFtest.java","0","0","0","0","0"
"4","TestHiveFunctionLoader.java","0","0","0","0","0"
"4","TestHiveFunctions.java","0","0","0","0","0"
"4","NullTestFunction.java","0","0","0","0","0"
"4","TestAggFunction.java","0","0","0","0","0"
"4","TestBuiltinFunctions.java","25953","35467","61420","141656","35414.0"
"4","TestConditionalExpressions.java","0","0","0","0","0"
"4","TestDateTimeFunctions.java","0","0","0","0","0"
"4","TestFunctionLoader.java","150215","295778","445993","150215","37553.0"
"4","TestGeneralFunction.java","0","0","0","0","0"
"4","TestJsonFunctions.java","46246","106952","153198","46246","11561.0"
"4","TestMathFunctions.java","119262","377557","496819","126418","31604.0"
"4","TestPatternMatchingPredicates.java","0","0","0","0","0"
"4","TestPythonFunctions.java","1668","4550","6218","1668","417.0"
"4","TestStringOperatorsAndFunctions.java","0","0","0","0","0"
"4","TestUserDefinedFunctions.java","0","0","0","0","0"
"4","TestMasterPlan.java","0","0","0","0","0"
"4","TestExternalSortExec.java","83580","371138","454718","141335","35333.0"
"4","TestFullOuterHashJoinExec.java","97986","378206","476192","141143","35285.0"
"4","TestFullOuterMergeJoinExec.java","97493","376548","474041","141653","35413.0"
"4","TestHashAntiJoinExec.java","79733","369078","448811","116292","29073.0"
"4","TestHashJoinExec.java","83566","375934","459500","141143","35285.0"
"4","TestHashPartitioner.java","83566","375934","459500","83566","20891.0"
"4","TestHashSemiJoinExec.java","75863","153344","229207","127525","31881.0"
"4","TestLeftOuterHashJoinExec.java","97507","331556","429063","141653","35413.0"
"4","TestMergeJoinExec.java","83566","375934","459500","141653","35413.0"
"4","TestPhysicalPlanner.java","83580","371138","454718","141653","35413.0"
"4","TestProgressExternalSortExec.java","147396","354519","501915","147396","36849.0"
"4","TestRadixSort.java","0","0","0","0","0"
"4","TestRightOuterHashJoinExec.java","97493","372756","470249","141143","35285.0"
"4","TestRightOuterMergeJoinExec.java","97493","372756","470249","141335","35333.0"
"4","TestSortExec.java","83580","371138","454718","134096","33524.0"
"4","TestSortIntersectExec.java","112995","131080","244075","112995","28248.0"
"4","TestTupleSorter.java","41314","102190","143504","41314","10328.0"
"4","TestUnSafeTuple.java","0","0","0","0","0"
"4","TestEvalNodeToExprConverter.java","0","0","0","0","0"
"4","TestJoinOrderAlgorithm.java","0","0","0","0","0"
"4","TestLogicalOptimizer.java","83566","379828","463394","127525","31881.0"
"4","TestLogicalPlan.java","93091","414659","507750","93091","23272.0"
"4","TestLogicalPlanner.java","83576","334402","417978","151024","37756.0"
"4","TestPlannerUtil.java","77336","177351","254687","133523","33380.0"
"4","TestQueryValidation.java","101319","194626","295945","101319","25329.0"
"4","TestUniformRangePartition.java","83566","375934","459500","117218","29304.0"
"4","TestAlterTable.java","148486","293626","442112","148486","37121.0"
"4","TestAlterTablespace.java","0","0","0","0","0"
"4","TestCaseByCases.java","0","0","0","0","0"
"4","TestCommonConditionReduce.java","0","0","0","0","0"
"4","TestCreateDatabase.java","0","0","0","0","0"
"4","TestCreateIndex.java","0","0","0","0","0"
"4","TestCreateTable.java","147333","354501","501834","147333","36833.0"
"4","TestCrossJoin.java","0","0","0","0","0"
"4","TestCTASQuery.java","130188","307144","437332","149717","37429.0"
"4","TestDropTable.java","0","0","0","0","0"
"4","TestGroupByQuery.java","85189","213897","299086","145518","36379.0"
"4","TestHBaseTable.java","56224","128780","185004","56224","14056.0"
"4","TestIndexScan.java","0","0","0","0","0"
"4","TestInnerJoinQuery.java","0","0","0","0","0"
"4","TestInnerJoinWithSubQuery.java","124473","150320","274793","124473","31118.0"
"4","TestInsertQuery.java","81960","377516","459476","131248","32812.0"
"4","TestInSubquery.java","0","0","0","0","0"
"4","TestJoinOnPartitionedTables.java","138212","351791","490003","138212","34553.0"
"4","TestJoinQuery.java","94875","258754","353629","124499","31124.0"
"4","TestJsonWithTimezone.java","0","0","0","0","0"
"4","TestMultipleJoinTypes.java","29163","38196","67359","29163","7290.0"
"4","TestNullValues.java","84587","423670","508257","139801","34950.0"
"4","TestOuterJoinQuery.java","8068","12633","20701","8068","2017.0"
"4","TestOuterJoinWithSubQuery.java","0","0","0","0","0"
"4","TestQueryOnSelfDescTable.java","1515","5833","7348","1515","378.0"
"4","TestSelectNestedRecord.java","39148","90524","129672","39148","9787.0"
"4","TestSelectQuery.java","83580","371269","454849","151146","37786.0"
"4","TestSetSessionQuery.java","130433","261567","392000","130433","32608.0"
"4","TestSimpleQuery.java","0","0","0","0","0"
"4","TestSortQuery.java","87058","203141","290199","141653","35413.0"
"4","TestTablePartitions.java","130635","317097","447732","130883","32720.0"
"4","TestTableSubQuery.java","0","0","0","0","0"
"4","TestTimezone.java","0","0","0","0","0"
"4","TestTruncateTable.java","0","0","0","0","0"
"4","TestUnionQuery.java","132708","300794","433502","132708","33177.0"
"4","TestWindowQuery.java","0","0","0","0","0"
"4","BenchmarkSort.java","0","0","0","0","0"
"4","TestTableCache.java","0","0","0","0","0"
"4","TestTupleUtil.java","83580","335453","419033","83580","20895.0"
"4","TestHAServiceHDFSImpl.java","91334","204836","296170","91334","22833.0"
"4","TestMasterRules.java","0","0","0","0","0"
"4","TestSimpleScheduler.java","0","0","0","0","0"
"4","TestExecutionBlockCursor.java","114721","373469","488190","119301","29825.0"
"4","TestNonForwardQueryResultSystemScanner.java","52232","118770","171002","52232","13058.0"
"4","TestQueryResult.java","0","0","0","0","0"
"4","TestRepartitioner.java","103646","264465","368111","103646","25911.0"
"4","TestSQLAnalyzer.java","77440","393686","471126","77440","19360.0"
"4","TestIntermediateEntry.java","0","0","0","0","0"
"4","TestKillQuery.java","88752","137207","225959","88752","22188.0"
"4","TestQueryProgress.java","0","0","0","0","0"
"4","TestQueryState.java","31801","77988","109789","31801","7950.0"
"4","TestTaskStatusUpdate.java","143386","363075","506461","143386","35846.0"
"4","TestResources.java","0","0","0","0","0"
"4","TestFileFragment.java","0","0","0","0","0"
"4","TestQueryOnOrcFile.java","0","0","0","0","0"
"4","TestQueryIdFactory.java","0","0","0","0","0"
"4","TestTajoIds.java","0","0","0","0","0"
"4","TestHistoryWriterReader.java","89762","180485","270247","89762","22440.0"
"4","TestJMXTajoObjectNameFactory.java","0","0","0","0","0"
"4","TestMetricsFilter.java","0","0","0","0","0"
"4","TestSystemMetrics.java","129236","370559","499795","129236","32309.0"
"4","TestIPconvertUtil.java","0","0","0","0","0"
"4","TestJSPUtil.java","145259","398256","543515","145259","36314.0"
"4","TestRpcParamFactory.java","0","0","0","0","0"
"4","TestTimeZoneUtil.java","0","0","0","0","0"
"4","MockExecutionBlockContext.java","0","0","0","0","0"
"4","MockNodeResourceManager.java","18376","18104","36480","18376","4594.0"
"4","MockNodeStatusUpdater.java","24071","29501","53572","24071","6017.0"
"4","MockTaskExecutor.java","18376","18104","36480","18376","4594.0"
"4","MockTaskManager.java","18376","18104","36480","18376","4594.0"
"4","MockWorkerContext.java","0","0","0","0","0"
"4","TestDeletionService.java","0","0","0","0","0"
"4","TestFetcherWithTajoPullServer.java","0","0","0","0","0"
"4","TestNodeResourceManager.java","7998","13700","21698","7998","1999.0"
"4","TestNodeStatusUpdater.java","7998","13700","21698","7998","1999.0"
"4","TestTaskExecutor.java","18376","18104","36480","18376","4594.0"
"4","TestTaskManager.java","18376","18104","36480","18376","4594.0"
"4","TestClusterResource.java","0","0","0","0","0"
"4","TestDatabasesResource.java","0","0","0","0","0"
"4","TestFunctionsResource.java","24865","76158","101023","24865","6216.0"
"4","TestQueryResource.java","21796","69980","91776","21796","5449.0"
"4","TestQueryResultResource.java","21796","69980","91776","21796","5449.0"
"4","TestSessionsResource.java","0","0","0","0","0"
"4","TestTablesResource.java","27128","79851","106979","27128","6782.0"
"4","JdbcConnection.java","148691","362497","511188","148691","37172.0"
"4","TajoDatabaseMetaData.java","118419","373348","491767","129209","32302.0"
"4","TajoDriver.java","0","0","0","0","0"
"4","TajoPreparedStatement.java","117707","314502","432209","117707","29426.0"
"4","TajoStatement.java","117731","315004","432735","125666","31416.0"
"4","QueryStringDecoder.java","0","0","0","0","0"
"4","TestResultSet.java","83604","328038","411642","136953","34238.0"
"4","TestSQLState.java","0","0","0","0","0"
"4","TestTajoDatabaseMetaData.java","154682","299636","454318","154682","38670.0"
"4","TestTajoJdbc.java","117729","320370","438099","149388","37347.0"
"4","TestTajoJdbcNegative.java","6339","9293","15632","6339","1584.0"
"4","TestQueryStringDecoder.java","0","0","0","0","0"
"4","TestResultSetUtil.java","0","0","0","0","0"
"4","ProtocMojo.java","0","0","0","0","0"
"4","Exec.java","0","0","0","0","0"
"4","FileSetUtils.java","0","0","0","0","0"
"4","VersionInfoMojo.java","0","0","0","0","0"
"4","MetricsUtil.java","0","0","0","0","0"
"4","TestMetricsUtil.java","0","0","0","0","0"
"4","AlgebraVisitor.java","77524","380379","457903","77524","19381.0"
"4","BaseAlgebraVisitor.java","77160","331681","408841","134229","33557.0"
"4","Prioritized.java","0","0","0","0","0"
"4","AggregationFunctionCallEval.java","83594","319885","403479","83594","20898.0"
"4","AlgebraicException.java","0","0","0","0","0"
"4","AlgebraicUtil.java","83594","319885","403479","126168","31542.0"
"4","BasicEvalNodeVisitor.java","93007","387224","480231","121578","30394.0"
"4","BetweenPredicateEval.java","114248","313414","427662","129232","32308.0"
"4","BinaryEval.java","83604","321848","405452","126654","31663.0"
"4","CaseWhenEval.java","83594","319885","403479","129232","32308.0"
"4","CastEval.java","93149","316855","410004","127148","31787.0"
"4","ConstEval.java","83604","321848","405452","129232","32308.0"
"4","EvalContext.java","1668","4550","6218","1668","417.0"
"4","EvalNode.java","83604","321848","405452","92138","23034.0"
"4","EvalNodeVisitor.java","0","0","0","0","0"
"4","EvalNodeVisitor2.java","0","0","0","0","0"
"4","EvalTreeFactory.java","0","0","0","0","0"
"4","EvalTreeUtil.java","83594","319885","403479","151286","37821.0"
"4","EvalType.java","77737","389209","466946","91366","22841.0"
"4","FieldEval.java","83604","321848","405452","83604","20901.0"
"4","FunctionEval.java","83604","321848","405452","91822","22955.0"
"4","GeneralFunctionEval.java","83614","332037","415651","131777","32944.0"
"4","InEval.java","80748","317805","398553","80748","20187.0"
"4","InvalidEvalException.java","0","0","0","0","0"
"4","IsNullEval.java","83594","319885","403479","83594","20898.0"
"4","LikePredicateEval.java","0","0","0","0","0"
"4","NotEval.java","83604","321848","405452","83604","20901.0"
"4","PartialBinaryExpr.java","83604","321848","405452","83604","20901.0"
"4","PatternMatchPredicateEval.java","92807","319105","411912","129292","32323.0"
"4","RegexPredicateEval.java","92794","317139","409933","92794","23198.0"
"4","RowConstantEval.java","80738","333257","413995","80738","20184.0"
"4","SignedEval.java","123645","311898","435543","123645","30911.0"
"4","SimilarToPredicateEval.java","0","0","0","0","0"
"4","SimpleEvalNodeVisitor.java","100517","297002","397519","100517","25129.0"
"4","SubqueryEval.java","0","0","0","0","0"
"4","UnaryEval.java","84891","222523","307414","84891","21222.0"
"4","ValueSetEval.java","0","0","0","0","0"
"4","WindowFunctionEval.java","84216","202510","286726","84216","21054.0"
"4","ExprAnnotator.java","133637","314134","447771","148715","37178.0"
"4","ExprNormalizer.java","134808","363604","498412","134808","33702.0"
"4","EvalTreeOptimizationRule.java","0","0","0","0","0"
"4","EvalTreeOptimizer.java","0","0","0","0","0"
"4","ConstantFolding.java","86258","188375","274633","86258","21564.0"
"4","ConstantPropagation.java","0","0","0","0","0"
"4","AggFunction.java","83622","334927","418549","83622","20905.0"
"4","AggFunctionInvoke.java","0","0","0","0","0"
"4","ClassBasedAggFunctionInvoke.java","0","0","0","0","0"
"4","ClassBasedScalarFunctionInvoke.java","1668","4550","6218","1668","417.0"
"4","FunctionContext.java","0","0","0","0","0"
"4","FunctionInvoke.java","83256","142984","226240","83256","20814.0"
"4","FunctionInvokeContext.java","1668","4550","6218","1668","417.0"
"4","GeneralFunction.java","0","0","0","0","0"
"4","HiveFunctionInvoke.java","0","0","0","0","0"
"4","PythonScriptEngine.java","1668","4550","6218","1668","417.0"
"4","TajoScriptEngine.java","1668","4550","6218","1668","417.0"
"4","PythonAggFunctionInvoke.java","0","0","0","0","0"
"4","PythonFunctionInvoke.java","0","0","0","0","0"
"4","BufferPool.java","66502","110968","177470","66502","16625.0"
"4","ByteBufInputChannel.java","0","0","0","0","0"
"4","ByteBufLineReader.java","63231","103724","166955","63231","15807.0"
"4","CSVLineDeserializer.java","57980","81059","139039","57980","14495.0"
"4","CSVLineSerDe.java","66186","103979","170165","66186","16546.0"
"4","CSVLineSerializer.java","57980","81059","139039","57980","14495.0"
"4","FieldSerializerDeserializer.java","66502","110968","177470","66502","16625.0"
"4","FieldSplitProcessor.java","0","0","0","0","0"
"4","InputHandler.java","0","0","0","0","0"
"4","LineSplitProcessor.java","0","0","0","0","0"
"4","OutputHandler.java","1668","4550","6218","1668","417.0"
"4","StreamingUtil.java","1668","4550","6218","1668","417.0"
"4","TextFieldSerializerDeserializer.java","63232","103870","167102","63232","15808.0"
"4","TextLineDeserializer.java","66186","103979","170165","66186","16546.0"
"4","TextLineParsingError.java","0","0","0","0","0"
"4","TextLineSerDe.java","66186","103979","170165","66186","16546.0"
"4","TextLineSerializer.java","1668","4550","6218","1668","417.0"
"4","WindowAggFunc.java","0","0","0","0","0"
"4","Edge.java","0","0","0","0","0"
"4","FoundJoinOrder.java","0","0","0","0","0"
"4","GreedyHeuristicJoinOrderAlgorithm.java","114885","313549","428434","133403","33350.0"
"4","JoinEdge.java","100877","377154","478031","100877","25219.0"
"4","JoinedRelationsVertex.java","0","0","0","0","0"
"4","JoinGraph.java","100877","377154","478031","100877","25219.0"
"4","JoinGraphContext.java","18640","16847","35487","18640","4660.0"
"4","JoinOrderAlgorithm.java","114909","376647","491556","119906","29976.0"
"4","JoinOrderingUtil.java","22597","29806","52403","22597","5649.0"
"4","JoinVertex.java","0","0","0","0","0"
"4","RelationVertex.java","0","0","0","0","0"
"4","AlterTableNode.java","148149","290586","438735","148149","37037.0"
"4","AlterTablespaceNode.java","0","0","0","0","0"
"4","BinaryNode.java","0","0","0","0","0"
"4","CreateDatabaseNode.java","0","0","0","0","0"
"4","CreateIndexNode.java","0","0","0","0","0"
"4","CreateTableNode.java","83566","379726","463292","141361","35340.0"
"4","DistinctGroupbyNode.java","84248","209111","293359","84248","21062.0"
"4","DropDatabaseNode.java","0","0","0","0","0"
"4","DropIndexNode.java","0","0","0","0","0"
"4","DropTableNode.java","0","0","0","0","0"
"4","EvalExprNode.java","83594","319885","403479","83594","20898.0"
"4","ExceptNode.java","0","0","0","0","0"
"4","GroupbyNode.java","83594","319885","403479","136558","34139.0"
"4","GroupElement.java","0","0","0","0","0"
"4","HavingNode.java","132708","301073","433781","132708","33177.0"
"4","IndexScanNode.java","83594","319885","403479","83594","20898.0"
"4","InsertNode.java","81982","317669","399651","136558","34139.0"
"4","IntersectNode.java","0","0","0","0","0"
"4","JoinNode.java","83594","319885","403479","83594","20898.0"
"4","JoinSpec.java","0","0","0","0","0"
"4","LimitNode.java","83594","319885","403479","128255","32063.0"
"4","LogicalNode.java","0","0","0","0","0"
"4","LogicalNodeVisitor.java","0","0","0","0","0"
"4","LogicalRootNode.java","0","0","0","0","0"
"4","NodeType.java","77571","382999","460570","123744","30936.0"
"4","PartitionedTableScanNode.java","132234","413344","545578","132234","33058.0"
"4","PersistentStoreNode.java","128902","303007","431909","128902","32225.0"
"4","Projectable.java","0","0","0","0","0"
"4","ProjectionNode.java","83594","319885","403479","148314","37078.0"
"4","RelationNode.java","92070","332718","424788","92070","23017.0"
"4","ScanNode.java","84545","415025","499570","126804","31701.0"
"4","SelectableNode.java","0","0","0","0","0"
"4","SelectionNode.java","83594","319885","403479","90651","22662.0"
"4","SetOperationNode.java","0","0","0","0","0"
"4","SetSessionNode.java","0","0","0","0","0"
"4","ShuffleFileWriteNode.java","128902","303007","431909","128902","32225.0"
"4","SortNode.java","83594","319885","403479","83594","20898.0"
"4","StoreTableNode.java","83594","319885","403479","129240","32310.0"
"4","TableSubQueryNode.java","93152","421129","514281","93152","23288.0"
"4","TruncateTableNode.java","89267","219525","308792","89267","22316.0"
"4","UnaryNode.java","0","0","0","0","0"
"4","UnionNode.java","0","0","0","0","0"
"4","WindowAggNode.java","134154","347585","481739","134154","33538.0"
"4","WindowSpec.java","0","0","0","0","0"
"4","LogicalOptimizer.java","83567","382932","466499","128255","32063.0"
"4","LogicalPlan.java","76719","320148","396867","128342","32085.0"
"4","LogicalPlanner.java","83604","322153","405757","148671","37167.0"
"4","LogicalPlanPreprocessor.java","135500","380493","515993","135500","33875.0"
"4","NamedExprsManager.java","0","0","0","0","0"
"4","NameResolver.java","89225","209410","298635","89225","22306.0"
"4","NameResolvingMode.java","0","0","0","0","0"
"4","ResolverByLegacy.java","106180","277410","383590","106180","26545.0"
"4","ResolverByRels.java","137762","338235","475997","137762","34440.0"
"4","ResolverByRelsAndSubExprs.java","137762","338235","475997","137762","34440.0"
"4","ResolverBySubExprsAndRels.java","137762","338235","475997","137762","34440.0"
"4","PlanString.java","93091","414659","507750","93091","23272.0"
"4","BaseLogicalPlanPreprocessEngine.java","0","0","0","0","0"
"4","BaseLogicalPlanPreprocessPhaseProvider.java","0","0","0","0","0"
"4","BaseLogicalPlanRewriteEngine.java","0","0","0","0","0"
"4","BaseLogicalPlanRewriteRuleProvider.java","67172","146683","213855","67172","16793.0"
"4","BaseSchemaBuildPhase.java","2958","22080","25038","2958","739.0"
"4","LogicalPlanPreprocessEngine.java","0","0","0","0","0"
"4","LogicalPlanPreprocessPhase.java","0","0","0","0","0"
"4","LogicalPlanPreprocessPhaseProvider.java","0","0","0","0","0"
"4","LogicalPlanRewriteEngine.java","0","0","0","0","0"
"4","LogicalPlanRewriteRule.java","0","0","0","0","0"
"4","LogicalPlanRewriteRuleContext.java","115965","156612","272577","115965","28991.0"
"4","LogicalPlanRewriteRuleProvider.java","0","0","0","0","0"
"4","LogicalPlanTestRuleProvider.java","0","0","0","0","0"
"4","AccessPathInfo.java","0","0","0","0","0"
"4","AccessPathRewriter.java","0","0","0","0","0"
"4","CommonConditionReduceRule.java","95581","98270","193851","95581","23895.0"
"4","FilterPushDownRule.java","75619","318358","393977","151201","37800.0"
"4","IndexScanInfo.java","0","0","0","0","0"
"4","InSubqueryRewriteRule.java","0","0","0","0","0"
"4","LogicalPlanEqualityTester.java","65395","138862","204257","65395","16348.0"
"4","PartitionedTableRewriter.java","131358","370711","502069","136489","34122.0"
"4","ProjectionPushDownRule.java","75629","320626","396255","144014","36003.0"
"4","SeqScanInfo.java","0","0","0","0","0"
"4","SelfDescSchemaBuildPhase.java","1515","5833","7348","1515","378.0"
"4","TableStatUpdateRewriter.java","5027","8110","13137","5027","1256.0"
"4","EvalNodeAdapter.java","0","0","0","0","0"
"4","EvalNodeDeserializer.java","87172","184261","271433","87172","21793.0"
"4","EvalNodeSerializer.java","91604","200825","292429","91604","22901.0"
"4","LogicalNodeAdapter.java","0","0","0","0","0"
"4","LogicalNodeDeserializer.java","23033","29473","52506","23033","5758.0"
"4","LogicalNodeSerializer.java","23033","29473","52506","23033","5758.0"
"4","package-info.java","0","0","0","0","0"
"4","PlanGsonHelper.java","0","0","0","0","0"
"4","StorageService.java","123914","158234","282148","123914","30978.0"
"4","TablePropertyUtil.java","127059","169535","296594","127059","31764.0"
"4","Target.java","0","0","0","0","0"
"4","TypeDeterminant.java","101142","272816","373958","101142","25285.0"
"4","EvalNodeToExprConverter.java","5892","9575","15467","5892","1473.0"
"4","ExprFinder.java","134808","364207","499015","134808","33702.0"
"4","PartitionFilterAlgebraVisitor.java","0","0","0","0","0"
"4","PlannerUtil.java","83594","320036","403630","151024","37756.0"
"4","WritableTypeConverter.java","0","0","0","0","0"
"4","ExprsVerifier.java","115067","415470","530537","127633","31908.0"
"4","LogicalPlanVerifier.java","113857","328959","442816","123305","30826.0"
"4","PostLogicalPlanVerifier.java","0","0","0","0","0"
"4","PreLogicalPlanVerifier.java","135350","317304","452654","141338","35334.0"
"4","SyntaxErrorException.java","114440","374153","488593","114440","28610.0"
"4","SyntaxErrorUtil.java","113147","127045","240192","113147","28286.0"
"4","VerificationState.java","114348","374419","488767","114348","28587.0"
"4","BasicLogicalPlanVisitor.java","75619","318358","393977","149801","37450.0"
"4","ExplainLogicalPlanVisitor.java","92493","378713","471206","128255","32063.0"
"4","LogicalPlanVisitor.java","76023","379796","455819","130110","32527.0"
"4","SimpleAlgebraVisitor.java","134808","364207","499015","134808","33702.0"
"4","TestExprAnnotator.java","0","0","0","0","0"
"4","TestLogicalNode.java","0","0","0","0","0"
"4","TestWritableTypeConverter.java","0","0","0","0","0"
"4","FadvisedChunkedFile.java","0","0","0","0","0"
"4","FadvisedFileRegion.java","0","0","0","0","0"
"4","FileAccessForbiddenException.java","0","0","0","0","0"
"4","FileCloseListener.java","0","0","0","0","0"
"4","HttpDataServerChannelInitializer.java","0","0","0","0","0"
"4","HttpDataServerHandler.java","84547","417220","501767","84547","21136.0"
"4","HttpUtil.java","0","0","0","0","0"
"4","PullServerConstants.java","0","0","0","0","0"
"4","PullServerUtil.java","0","0","0","0","0"
"4","AdvancedDataRetriever.java","0","0","0","0","0"
"4","DataRetriever.java","0","0","0","0","0"
"4","DirectoryRetriever.java","0","0","0","0","0"
"4","FileChunk.java","0","0","0","0","0"
"4","FileChunkMeta.java","0","0","0","0","0"
"4","IndexCacheKey.java","0","0","0","0","0"
"4","RetrieverHandler.java","0","0","0","0","0"
"4","TajoPullServer.java","0","0","0","0","0"
"4","TajoPullServerService.java","80973","319819","400792","127555","31888.0"
"4","NettyServerBase.java","4612","8692","13304","136083","34020.0"
"4","NettyUtils.java","6187","30766","36953","6187","1546.0"
"4","RemoteException.java","0","0","0","0","0"
"4","RetriesExhaustedException.java","0","0","0","0","0"
"4","RpcConstants.java","0","0","0","0","0"
"4","RpcEventListener.java","0","0","0","0","0"
"4","RpcUtils.java","11197","14951","26148","11197","2799.0"
"4","AsyncRpcClient.java","83622","333683","417305","111725","27931.0"
"4","AsyncRpcServer.java","83604","328674","412278","135526","33881.0"
"4","BlockingRpcClient.java","82786","316317","399103","131477","32869.0"
"4","BlockingRpcServer.java","83604","328674","412278","135526","33881.0"
"4","CallFuture.java","83622","333683","417305","111713","27928.0"
"4","CancelableRpcCallback.java","0","0","0","0","0"
"4","ChannelEventListener.java","4696","9687","14383","4696","1174.0"
"4","DefaultRpcController.java","0","0","0","0","0"
"4","MonitorClientHandler.java","0","0","0","0","0"
"4","MonitorServerHandler.java","0","0","0","0","0"
"4","MonitorStateEvent.java","0","0","0","0","0"
"4","NettyClientBase.java","1175","2904","4079","84432","21108.0"
"4","NettyRpcController.java","0","0","0","0","0"
"4","NullCallback.java","83604","328510","412114","83604","20901.0"
"4","ProtoClientChannelInitializer.java","12183","30442","42625","12183","3045.0"
"4","ProtoDeclaration.java","0","0","0","0","0"
"4","ProtoServerChannelInitializer.java","0","0","0","0","0"
"4","RecoverableException.java","4696","9687","14383","4696","1174.0"
"4","RemoteCallException.java","0","0","0","0","0"
"4","RpcClientManager.java","4696","9687","14383","4696","1174.0"
"4","RpcConnectionKey.java","0","0","0","0","0"
"4","TajoServiceException.java","0","0","0","0","0"
"4","DummyProtocolAsyncImpl.java","83622","333683","417305","83622","20905.0"
"4","DummyProtocolBlockingImpl.java","83622","333683","417305","83622","20905.0"
"4","TestAsyncRpc.java","83604","328674","412278","145040","36260.0"
"4","TestBlockingRpc.java","83604","328674","412278","145040","36260.0"
"4","TestRpcClientManager.java","4696","9687","14383","4696","1174.0"
"4","GsonFeature.java","3540","11523","15063","3540","885.0"
"4","GsonReader.java","0","0","0","0","0"
"4","GsonUtil.java","0","0","0","0","0"
"4","GsonWriter.java","0","0","0","0","0"
"4","NettyRestChannelInitializer.java","0","0","0","0","0"
"4","NettyRestHandlerContainer.java","0","0","0","0","0"
"4","NettyRestHandlerContainerProvider.java","0","0","0","0","0"
"4","NettyRestServer.java","0","0","0","0","0"
"4","NettyRestServerFactory.java","0","0","0","0","0"
"4","NettyRestServerListener.java","0","0","0","0","0"
"4","ResourceConfigUtil.java","0","0","0","0","0"
"4","NettyRestHandlerContainerProviderTest.java","0","0","0","0","0"
"4","NettyRestServerTest.java","0","0","0","0","0"
"4","TestApplication1.java","0","0","0","0","0"
"4","TestResource1.java","0","0","0","0","0"
"4","DirectoriesDao.java","0","0","0","0","0"
"4","DirectoriesResource.java","0","0","0","0","0"
"4","Directory.java","0","0","0","0","0"
"4","FileManagementApplication.java","0","0","0","0","0"
"4","AbstractScanner.java","84967","154628","239595","84967","21241.0"
"4","ForSplitableStore.java","0","0","0","0","0"
"4","Appender.java","84573","423058","507631","84573","21143.0"
"4","BaseTupleComparator.java","126971","262752","389723","126971","31742.0"
"4","BinarySerializerDeserializer.java","117863","327845","445708","117863","29465.0"
"4","ByteBufInputChannel.java","0","0","0","0","0"
"4","CodecPool.java","0","0","0","0","0"
"4","DataLocation.java","0","0","0","0","0"
"4","DiskDeviceInfo.java","0","0","0","0","0"
"4","DiskInfo.java","0","0","0","0","0"
"4","DiskMountInfo.java","0","0","0","0","0"
"4","DiskUtil.java","0","0","0","0","0"
"4","AlreadyExistsStorageException.java","0","0","0","0","0"
"4","UnknownCodecException.java","0","0","0","0","0"
"4","UnsupportedFileTypeException.java","0","0","0","0","0"
"4","FormatProperty.java","0","0","0","0","0"
"4","BuiltinFragmentKinds.java","0","0","0","0","0"
"4","Fragment.java","0","0","0","0","0"
"4","FragmentConvertor.java","0","0","0","0","0"
"4","FragmentSerde.java","0","0","0","0","0"
"4","FrameTuple.java","83580","334734","418314","119497","29874.0"
"4","FSDataInputChannel.java","85801","148391","234192","85801","21450.0"
"4","InputChannel.java","0","0","0","0","0"
"4","LazyTuple.java","137868","356609","494477","137868","34467.0"
"4","LocalFileInputChannel.java","41398","95910","137308","41398","10349.0"
"4","MergeScanner.java","83566","379828","463394","138158","34539.0"
"4","NullScanner.java","106029","190576","296605","106029","26507.0"
"4","NumericPathComparator.java","0","0","0","0","0"
"4","OldStorageManager.java","0","0","0","0","0"
"4","RowStoreUtil.java","83580","335453","419033","149253","37313.0"
"4","Scanner.java","83578","335331","418909","83578","20894.0"
"4","SeekableChannel.java","0","0","0","0","0"
"4","SeekableInputChannel.java","0","0","0","0","0"
"4","SeekableScanner.java","0","0","0","0","0"
"4","SerializerDeserializer.java","117849","368326","486175","117849","29462.0"
"4","StorageProperty.java","83566","379726","463292","83566","20891.0"
"4","StorageUtil.java","82764","315340","398104","82764","20691.0"
"4","Tablespace.java","51242","115196","166438","51242","12810.0"
"4","TablespaceManager.java","16903","61846","78749","16903","4225.0"
"4","TableStatistics.java","143733","404428","548161","143733","35933.0"
"4","TextSerializerDeserializer.java","117863","327845","445708","127213","31803.0"
"4","TupleComparator.java","0","0","0","0","0"
"4","TupleRange.java","0","0","0","0","0"
"4","TestFrameTuple.java","0","0","0","0","0"
"4","TestLazyTuple.java","90388","373387","463775","90388","22597.0"
"4","TestTupleComparator.java","83566","375934","459500","83566","20891.0"
"4","TestVTuple.java","0","0","0","0","0"
"4","AbstractHBaseAppender.java","71495","152828","224323","71495","17873.0"
"4","ColumnMapping.java","56224","128780","185004","56224","14056.0"
"4","HBaseBinarySerializerDeserializer.java","39567","67716","107283","39567","9891.0"
"4","HBaseFragment.java","0","0","0","0","0"
"4","HBaseFragmentSerde.java","0","0","0","0","0"
"4","HBasePutAppender.java","56224","128780","185004","56224","14056.0"
"4","HBaseScanner.java","39567","67716","107283","39567","9891.0"
"4","HBaseStorageConstants.java","0","0","0","0","0"
"4","HBaseTablespace.java","39567","67716","107283","39567","9891.0"
"4","HBaseTextSerializerDeserializer.java","0","0","0","0","0"
"4","HFileAppender.java","0","0","0","0","0"
"4","IndexPredication.java","0","0","0","0","0"
"4","RegionSizeCalculator.java","0","0","0","0","0"
"4","RowKeyMapping.java","0","0","0","0","0"
"4","SortedInsertRewriter.java","56224","128780","185004","56224","14056.0"
"4","TestColumnMapping.java","116215","231739","347954","116215","29053.0"
"4","TestHBaseTableSpace.java","56224","128780","185004","56224","14056.0"
"4","AvroAppender.java","160265","391040","551305","160265","40066.0"
"4","AvroScanner.java","157001","351755","508756","157001","39250.0"
"4","AvroUtil.java","160703","397933","558636","160703","40175.0"
"4","package-info.java","0","0","0","0","0"
"4","FieldSerializerDeserializer.java","66502","110968","177470","66502","16625.0"
"4","FileAppender.java","83566","379726","463292","83566","20891.0"
"4","FileScanner.java","84545","415025","499570","84545","21136.0"
"4","FileTablespace.java","90591","146028","236619","90591","22647.0"
"4","AbstractFileFragment.java","0","0","0","0","0"
"4","FileFragment.java","0","0","0","0","0"
"4","FileFragmentSerde.java","0","0","0","0","0"
"4","HashShuffleAppenderManager.java","144643","343056","487699","144643","36160.0"
"4","HashShuffleAppenderWrapper.java","143976","336073","480049","143976","35994.0"
"4","BSTIndex.java","83983","381677","465660","127871","31967.0"
"4","IndexMethod.java","0","0","0","0","0"
"4","IndexReader.java","0","0","0","0","0"
"4","IndexWriter.java","0","0","0","0","0"
"4","OrderIndexReader.java","0","0","0","0","0"
"4","JsonLineDeserializer.java","63143","96626","159769","63143","15785.0"
"4","JsonLineSerDe.java","67681","108322","176003","67681","16920.0"
"4","JsonLineSerializer.java","90613","182630","273243","90613","22653.0"
"4","ORCAppender.java","5455","17689","23144","5455","1363.0"
"4","OrcScanner.java","0","0","0","0","0"
"4","package-info.java","0","0","0","0","0"
"4","package-info.java","0","0","0","0","0"
"4","ParquetAppender.java","153228","399798","553026","153228","38307.0"
"4","ParquetScanner.java","149994","354731","504725","149994","37498.0"
"4","TajoParquetReader.java","0","0","0","0","0"
"4","TajoParquetWriter.java","0","0","0","0","0"
"4","TajoReadSupport.java","0","0","0","0","0"
"4","TajoRecordConverter.java","153299","402479","555778","153299","38324.0"
"4","TajoRecordMaterializer.java","153299","402479","555778","153299","38324.0"
"4","TajoSchemaConverter.java","0","0","0","0","0"
"4","TajoWriteSupport.java","149474","309432","458906","149474","37368.0"
"4","DirectRawFileScanner.java","105778","116572","222350","105778","26444.0"
"4","DirectRawFileWriter.java","4513","9802","14315","4513","1128.0"
"4","RawFile.java","84576","423565","508141","138350","34587.0"
"4","BytesRefArrayWritable.java","0","0","0","0","0"
"4","BytesRefWritable.java","0","0","0","0","0"
"4","ColumnProjectionUtils.java","0","0","0","0","0"
"4","LazyDecompressionCallback.java","0","0","0","0","0"
"4","NonSyncByteArrayInputStream.java","0","0","0","0","0"
"4","NonSyncByteArrayOutputStream.java","0","0","0","0","0"
"4","NonSyncDataInputBuffer.java","0","0","0","0","0"
"4","NonSyncDataOutputBuffer.java","0","0","0","0","0"
"4","RCFile.java","117837","326712","444549","148650","37162.0"
"4","SchemaAwareCompressionInputStream.java","0","0","0","0","0"
"4","SchemaAwareCompressionOutputStream.java","0","0","0","0","0"
"4","RegexLineDeserializer.java","0","0","0","0","0"
"4","RegexLineSerDe.java","0","0","0","0","0"
"4","RegexLineSerializer.java","0","0","0","0","0"
"4","SequenceFileAppender.java","151528","348959","500487","151528","37882.0"
"4","SequenceFileScanner.java","151394","308210","459604","151394","37848.0"
"4","ByteBufLineReader.java","63231","103724","166955","63231","15807.0"
"4","CSVLineDeserializer.java","57980","81059","139039","57980","14495.0"
"4","CSVLineSerDe.java","66186","103979","170165","66186","16546.0"
"4","CSVLineSerializer.java","57980","81059","139039","57980","14495.0"
"4","DelimitedLineReader.java","63231","103724","166955","63231","15807.0"
"4","DelimitedTextFile.java","63231","103724","166955","63231","15807.0"
"4","FieldSplitProcessor.java","0","0","0","0","0"
"4","LineSplitProcessor.java","0","0","0","0","0"
"4","MultiBytesFieldSplitProcessor.java","0","0","0","0","0"
"4","TextFieldSerializerDeserializer.java","63232","103870","167102","63232","15808.0"
"4","TextLineDeserializer.java","66186","103979","170165","66186","16546.0"
"4","TextLineParsingError.java","0","0","0","0","0"
"4","TextLineSerDe.java","66186","103979","170165","66186","16546.0"
"4","TextLineSerializer.java","1668","4550","6218","1668","417.0"
"4","ByteBufferAllocatorPool.java","0","0","0","0","0"
"4","ByteBufferPoolAdapter.java","0","0","0","0","0"
"4","OrcConf.java","0","0","0","0","0"
"4","OrcFile.java","0","0","0","0","0"
"4","OrcRecordReader.java","0","0","0","0","0"
"4","OrcUtils.java","0","0","0","0","0"
"4","package-info.java","0","0","0","0","0"
"4","RecordReaderUtils.java","0","0","0","0","0"
"4","TreeReaderFactory.java","0","0","0","0","0"
"4","BloomFilter.java","0","0","0","0","0"
"4","Murmur3.java","0","0","0","0","0"
"4","Writer.java","0","0","0","0","0"
"4","WriterImpl.java","0","0","0","0","0"
"4","ZeroCopyAdapter.java","0","0","0","0","0"
"4","InternalParquetRecordReader.java","0","0","0","0","0"
"4","ParquetReader.java","0","0","0","0","0"
"4","HttpFileServer.java","0","0","0","0","0"
"4","HttpFileServerChannelInitializer.java","0","0","0","0","0"
"4","HttpFileServerHandler.java","0","0","0","0","0"
"4","TestAvroUtil.java","129588","258715","388303","129588","32397.0"
"4","TestBSTIndex.java","83566","375934","459500","126775","31693.0"
"4","TestSingleCSVFileBSTIndex.java","83566","375934","459500","122361","30590.0"
"4","TestJsonSerDe.java","122663","219137","341800","122663","30665.0"
"4","TestReadWrite.java","0","0","0","0","0"
"4","TestSchemaConverter.java","0","0","0","0","0"
"4","TestDirectRawFile.java","105778","116572","222350","105778","26444.0"
"4","TestRegexSerDe.java","0","0","0","0","0"
"4","TestByteBufLineReader.java","0","0","0","0","0"
"4","TestCompressionStorages.java","80398","377760","458158","128165","32041.0"
"4","TestDelimitedTextFile.java","78672","159409","238081","78672","19668.0"
"4","TestFileSystems.java","75395","152684","228079","75395","18848.0"
"4","TestFileTablespace.java","83566","375934","459500","149184","37296.0"
"4","TestLineReader.java","63231","103724","166955","63231","15807.0"
"4","TestMergeScanner.java","83578","335331","418909","83578","20894.0"
"4","TestSplitProcessor.java","58383","88135","146518","58383","14595.0"
"4","TestStorages.java","83576","334342","417918","150371","37592.0"
"4","TestStorageUtil.java","0","0","0","0","0"
"4","ConnectionInfo.java","0","0","0","0","0"
"4","JdbcFragment.java","0","0","0","0","0"
"4","JdbcFragmentSerde.java","0","0","0","0","0"
"4","JdbcMetadataProviderBase.java","0","0","0","0","0"
"4","JdbcScanner.java","0","0","0","0","0"
"4","JdbcTablespace.java","0","0","0","0","0"
"4","SQLBuilder.java","0","0","0","0","0"
"4","SQLExpressionGenerator.java","0","0","0","0","0"
"4","TestConnectionInfo.java","0","0","0","0","0"
"4","KafkaFragment.java","0","0","0","0","0"
"4","KafkaFragmentSerde.java","0","0","0","0","0"
"4","KafkaScanner.java","0","0","0","0","0"
"4","KafkaStorageConstants.java","0","0","0","0","0"
"4","KafkaTablespace.java","0","0","0","0","0"
"4","SimpleConsumerManager.java","0","0","0","0","0"
"4","KafkaTestUtil.java","0","0","0","0","0"
"4","EmbeddedKafka.java","0","0","0","0","0"
"4","EmbeddedZookeeper.java","0","0","0","0","0"
"4","TestKafkaQuery.java","0","0","0","0","0"
"4","TestKafkaScanner.java","0","0","0","0","0"
"4","TestKafkaTablespace.java","0","0","0","0","0"
"4","TestSimpleConsumerManager.java","0","0","0","0","0"
"4","PgSQLJdbcScanner.java","0","0","0","0","0"
"4","PgSQLMetadataProvider.java","0","0","0","0","0"
"4","PgSQLTablespace.java","0","0","0","0","0"
"4","PgSQLTestServer.java","0","0","0","0","0"
"4","TestPgSQLEndPointTests.java","0","0","0","0","0"
"4","TestPgSQLJdbcTableSpace.java","446","708","1154","446","111.0"
"4","TestPgSQLMetadataProvider.java","0","0","0","0","0"
"4","TestPgSQLQueryTests.java","0","0","0","0","0"
"4","TestPgSQLSimpleQueryTests.java","0","0","0","0","0"
"4","AnonymousAWSCredentialsProvider.java","0","0","0","0","0"
"4","BasicAWSCredentialsProvider.java","0","0","0","0","0"
"4","S3TableSpace.java","1998","1485","3483","1998","499.0"
"4","TajoS3Constants.java","0","0","0","0","0"
"4","MockAmazonS3.java","0","0","0","0","0"
"4","MockObjectListing.java","0","0","0","0","0"
"4","MockS3FileSystem.java","0","0","0","0","0"
"4","TestS3TableSpace.java","0","0","0","0","0"
"4","ExampleHttpFileFragment.java","0","0","0","0","0"
"4","ExampleHttpFileFragmentSerde.java","0","0","0","0","0"
"4","ExampleHttpFileTablespace.java","0","0","0","0","0"
"4","ExampleHttpJsonLineReader.java","0","0","0","0","0"
"4","ExampleHttpJsonScanner.java","0","0","0","0","0"
"4","ExampleHttpServerHandler.java","0","0","0","0","0"
"4","ExampleHttpServerInitializer.java","0","0","0","0","0"
"4","ExampleHttpTablespaceTestServer.java","0","0","0","0","0"
"4","TestExampleHttpFileQuery.java","0","0","0","0","0"
"4","AnnotationVisitor.java","0","0","0","0","0"
"4","AnnotationWriter.java","0","0","0","0","0"
"4","Attribute.java","0","0","0","0","0"
"4","ByteVector.java","0","0","0","0","0"
"4","ClassReader.java","0","0","0","0","0"
"4","ClassVisitor.java","0","0","0","0","0"
"4","ClassWriter.java","0","0","0","0","0"
"4","AdviceAdapter.java","0","0","0","0","0"
"4","AnalyzerAdapter.java","145946","289520","435466","145946","36486.0"
"4","CodeSizeEvaluator.java","0","0","0","0","0"
"4","GeneratorAdapter.java","0","0","0","0","0"
"4","InstructionAdapter.java","0","0","0","0","0"
"4","JSRInlinerAdapter.java","145946","289520","435466","145946","36486.0"
"4","LocalVariablesSorter.java","0","0","0","0","0"
"4","Method.java","0","0","0","0","0"
"4","Remapper.java","0","0","0","0","0"
"4","RemappingAnnotationAdapter.java","0","0","0","0","0"
"4","RemappingClassAdapter.java","0","0","0","0","0"
"4","RemappingFieldAdapter.java","0","0","0","0","0"
"4","RemappingMethodAdapter.java","0","0","0","0","0"
"4","RemappingSignatureAdapter.java","0","0","0","0","0"
"4","SerialVersionUIDAdder.java","0","0","0","0","0"
"4","SimpleRemapper.java","0","0","0","0","0"
"4","StaticInitMerger.java","0","0","0","0","0"
"4","TableSwitchGenerator.java","0","0","0","0","0"
"4","TryCatchBlockSorter.java","0","0","0","0","0"
"4","Context.java","0","0","0","0","0"
"4","Edge.java","0","0","0","0","0"
"4","FieldVisitor.java","0","0","0","0","0"
"4","FieldWriter.java","0","0","0","0","0"
"4","Frame.java","0","0","0","0","0"
"4","Handle.java","0","0","0","0","0"
"4","Handler.java","0","0","0","0","0"
"4","Item.java","0","0","0","0","0"
"4","Label.java","0","0","0","0","0"
"4","MethodVisitor.java","0","0","0","0","0"
"4","MethodWriter.java","0","0","0","0","0"
"4","Opcodes.java","0","0","0","0","0"
"4","AnnotationConstantsCollector.java","0","0","0","0","0"
"4","ClassConstantsCollector.java","0","0","0","0","0"
"4","ClassOptimizer.java","0","0","0","0","0"
"4","Constant.java","0","0","0","0","0"
"4","ConstantPool.java","0","0","0","0","0"
"4","FieldConstantsCollector.java","0","0","0","0","0"
"4","JarOptimizer.java","0","0","0","0","0"
"4","MethodConstantsCollector.java","0","0","0","0","0"
"4","MethodOptimizer.java","0","0","0","0","0"
"4","NameMapping.java","0","0","0","0","0"
"4","Shrinker.java","0","0","0","0","0"
"4","SignatureReader.java","0","0","0","0","0"
"4","SignatureVisitor.java","0","0","0","0","0"
"4","SignatureWriter.java","0","0","0","0","0"
"4","AbstractInsnNode.java","0","0","0","0","0"
"4","Analyzer.java","145946","289520","435466","145946","36486.0"
"4","AnalyzerException.java","0","0","0","0","0"
"4","BasicInterpreter.java","0","0","0","0","0"
"4","BasicValue.java","0","0","0","0","0"
"4","BasicVerifier.java","0","0","0","0","0"
"4","Frame.java","0","0","0","0","0"
"4","Interpreter.java","0","0","0","0","0"
"4","SimpleVerifier.java","0","0","0","0","0"
"4","SmallSet.java","0","0","0","0","0"
"4","SourceInterpreter.java","0","0","0","0","0"
"4","SourceValue.java","0","0","0","0","0"
"4","Subroutine.java","0","0","0","0","0"
"4","Value.java","0","0","0","0","0"
"4","AnnotationNode.java","0","0","0","0","0"
"4","ClassNode.java","0","0","0","0","0"
"4","FieldInsnNode.java","0","0","0","0","0"
"4","FieldNode.java","0","0","0","0","0"
"4","FrameNode.java","0","0","0","0","0"
"4","IincInsnNode.java","0","0","0","0","0"
"4","InnerClassNode.java","0","0","0","0","0"
"4","InsnList.java","0","0","0","0","0"
"4","InsnNode.java","0","0","0","0","0"
"4","IntInsnNode.java","0","0","0","0","0"
"4","InvokeDynamicInsnNode.java","0","0","0","0","0"
"4","JumpInsnNode.java","0","0","0","0","0"
"4","LabelNode.java","0","0","0","0","0"
"4","LdcInsnNode.java","0","0","0","0","0"
"4","LineNumberNode.java","0","0","0","0","0"
"4","LocalVariableNode.java","0","0","0","0","0"
"4","LookupSwitchInsnNode.java","0","0","0","0","0"
"4","MethodInsnNode.java","0","0","0","0","0"
"4","MethodNode.java","0","0","0","0","0"
"4","MultiANewArrayInsnNode.java","0","0","0","0","0"
"4","TableSwitchInsnNode.java","0","0","0","0","0"
"4","TryCatchBlockNode.java","0","0","0","0","0"
"4","TypeInsnNode.java","0","0","0","0","0"
"4","VarInsnNode.java","0","0","0","0","0"
"4","Type.java","0","0","0","0","0"
"4","ASMifiable.java","0","0","0","0","0"
"4","ASMifier.java","0","0","0","0","0"
"4","CheckAnnotationAdapter.java","0","0","0","0","0"
"4","CheckClassAdapter.java","0","0","0","0","0"
"4","CheckFieldAdapter.java","0","0","0","0","0"
"4","CheckMethodAdapter.java","145946","289520","435466","145946","36486.0"
"4","CheckSignatureAdapter.java","0","0","0","0","0"
"4","Printer.java","0","0","0","0","0"
"4","Textifiable.java","0","0","0","0","0"
"4","Textifier.java","0","0","0","0","0"
"4","TraceAnnotationVisitor.java","0","0","0","0","0"
"4","TraceClassVisitor.java","0","0","0","0","0"
"4","TraceFieldVisitor.java","0","0","0","0","0"
"4","TraceMethodVisitor.java","0","0","0","0","0"
"4","TraceSignatureVisitor.java","0","0","0","0","0"
"4","ASMContentHandler.java","145946","289520","435466","145946","36486.0"
"4","Processor.java","0","0","0","0","0"
"4","SAXAdapter.java","0","0","0","0","0"
"4","SAXAnnotationAdapter.java","0","0","0","0","0"
"4","SAXClassAdapter.java","0","0","0","0","0"
"4","SAXCodeAdapter.java","0","0","0","0","0"
"4","SAXFieldAdapter.java","0","0","0","0","0"
"4","FadvisedChunkedFile.java","0","0","0","0","0"
"4","FadvisedFileRegion.java","0","0","0","0","0"
"4","FileCloseListener.java","0","0","0","0","0"
"4","TajoPullServerService.java","80973","319819","400792","127555","31888.0"
"5","Aggregation.java","0","0","0","0","0"
"5","AlterTable.java","151019","355352","506371","151019","30203.0"
"5","AlterTableOpType.java","0","0","0","0","0"
"5","AlterTablespace.java","0","0","0","0","0"
"5","AlterTablespaceSetType.java","0","0","0","0","0"
"5","BetweenPredicate.java","0","0","0","0","0"
"5","BinaryOperator.java","0","0","0","0","0"
"5","BooleanLiteral.java","0","0","0","0","0"
"5","CaseWhenPredicate.java","0","0","0","0","0"
"5","CastExpr.java","0","0","0","0","0"
"5","ColumnDefinition.java","0","0","0","0","0"
"5","ColumnReferenceExpr.java","0","0","0","0","0"
"5","CommonSubquery.java","0","0","0","0","0"
"5","CountRowsFunctionExpr.java","0","0","0","0","0"
"5","CreateDatabase.java","0","0","0","0","0"
"5","CreateIndex.java","0","0","0","0","0"
"5","CreateTable.java","77666","415656","493322","150213","30042.0"
"5","DataTypeExpr.java","93720","382665","476385","130539","26107.0"
"5","DateLiteral.java","0","0","0","0","0"
"5","DateValue.java","0","0","0","0","0"
"5","DropDatabase.java","0","0","0","0","0"
"5","DropIndex.java","0","0","0","0","0"
"5","DropTable.java","0","0","0","0","0"
"5","ExistsPredicate.java","0","0","0","0","0"
"5","Explain.java","0","0","0","0","0"
"5","Expr.java","0","0","0","0","0"
"5","ExprVisitor.java","0","0","0","0","0"
"5","FunctionExpr.java","0","0","0","0","0"
"5","GeneralSetFunctionExpr.java","0","0","0","0","0"
"5","Having.java","0","0","0","0","0"
"5","InPredicate.java","0","0","0","0","0"
"5","Insert.java","82480","385005","467485","82480","16496.0"
"5","IntervalLiteral.java","0","0","0","0","0"
"5","IsNullPredicate.java","0","0","0","0","0"
"5","Join.java","0","0","0","0","0"
"5","JoinType.java","0","0","0","0","0"
"5","JsonHelper.java","0","0","0","0","0"
"5","JsonSerializable.java","0","0","0","0","0"
"5","Limit.java","0","0","0","0","0"
"5","LiteralValue.java","0","0","0","0","0"
"5","NamedExpr.java","0","0","0","0","0"
"5","NotExpr.java","0","0","0","0","0"
"5","NullLiteral.java","0","0","0","0","0"
"5","OpType.java","0","0","0","0","0"
"5","PatternMatchPredicate.java","0","0","0","0","0"
"5","Projection.java","0","0","0","0","0"
"5","QualifiedAsteriskExpr.java","0","0","0","0","0"
"5","Relation.java","77329","389852","467181","77329","15465.0"
"5","RelationList.java","77329","389852","467181","77329","15465.0"
"5","ScalarSubQuery.java","0","0","0","0","0"
"5","Selection.java","0","0","0","0","0"
"5","SetOperation.java","0","0","0","0","0"
"5","SetSession.java","0","0","0","0","0"
"5","SignedExpr.java","0","0","0","0","0"
"5","SimpleTableSubquery.java","84209","390783","474992","84209","16841.0"
"5","Sort.java","84587","423733","508320","127179","25435.0"
"5","TablePrimarySubQuery.java","84209","390783","474992","84209","16841.0"
"5","TimeLiteral.java","0","0","0","0","0"
"5","TimestampLiteral.java","0","0","0","0","0"
"5","TimeValue.java","0","0","0","0","0"
"5","TruncateTable.java","0","0","0","0","0"
"5","UnaryOperator.java","0","0","0","0","0"
"5","ValueListExpr.java","0","0","0","0","0"
"5","Window.java","0","0","0","0","0"
"5","WindowFunctionExpr.java","0","0","0","0","0"
"5","WindowSpec.java","0","0","0","0","0"
"5","AlgebraTestingUtil.java","0","0","0","0","0"
"5","TestExpr.java","0","0","0","0","0"
"5","AbstractCatalogClient.java","83983","380705","464688","155736","31147.0"
"5","CatalogClient.java","84545","417217","501762","84545","16909.0"
"5","AlreadyRegisteredURIException.java","0","0","0","0","0"
"5","AlterTableDesc.java","153594","368778","522372","153647","30729.0"
"5","AlterTableType.java","0","0","0","0","0"
"5","AttributeType.java","0","0","0","0","0"
"5","CatalogConstants.java","0","0","0","0","0"
"5","CatalogService.java","148637","360175","508812","149862","29972.0"
"5","CatalogUtil.java","83567","381754","465321","155394","31078.0"
"5","Column.java","0","0","0","0","0"
"5","DDLBuilder.java","101144","378924","480068","142394","28478.0"
"5","FieldConverter.java","0","0","0","0","0"
"5","FunctionDesc.java","84208","389145","473353","129084","25816.0"
"5","FunctionDescBuilder.java","0","0","0","0","0"
"5","IndexDesc.java","84059","384589","468648","84059","16811.0"
"5","IndexMeta.java","0","0","0","0","0"
"5","CatalogGsonHelper.java","0","0","0","0","0"
"5","FunctionAdapter.java","0","0","0","0","0"
"5","SchemaAdapter.java","0","0","0","0","0"
"5","TableMetaAdapter.java","84587","423715","508302","84587","16917.0"
"5","ListSchemaBuilder.java","0","0","0","0","0"
"5","MetadataProvider.java","110444","136696","247140","110444","22088.0"
"5","NestedPathUtil.java","0","0","0","0","0"
"5","PartitionDesc.java","30019","89837","119856","139134","27826.0"
"5","PartitionMethodDesc.java","0","0","0","0","0"
"5","Schema.java","0","0","0","0","0"
"5","SchemaBuilder.java","0","0","0","0","0"
"5","SchemaFactory.java","0","0","0","0","0"
"5","SchemaLegacy.java","0","0","0","0","0"
"5","SchemaObject.java","0","0","0","0","0"
"5","SchemaUtil.java","83567","382932","466499","140405","28081.0"
"5","SetSchemaBuilder.java","0","0","0","0","0"
"5","SortSpec.java","84587","423733","508320","84587","16917.0"
"5","ColumnStats.java","0","0","0","0","0"
"5","Stat.java","0","0","0","0","0"
"5","StatisticsUtil.java","0","0","0","0","0"
"5","StatSet.java","0","0","0","0","0"
"5","TableStats.java","84547","417220","501767","123852","24770.0"
"5","TableDesc.java","114710","409530","524240","130877","26175.0"
"5","TableMeta.java","114747","413878","528625","114747","22949.0"
"5","TypeConverter.java","0","0","0","0","0"
"5","TypeDesc.java","0","0","0","0","0"
"5","DataTypeUtil.java","0","0","0","0","0"
"5","ClassBaseInvocationDesc.java","0","0","0","0","0"
"5","Function.java","0","0","0","0","0"
"5","FunctionCollection.java","0","0","0","0","0"
"5","FunctionInvocation.java","149192","286812","436004","149192","29838.0"
"5","FunctionSignature.java","0","0","0","0","0"
"5","FunctionSupplement.java","0","0","0","0","0"
"5","FunctionUtil.java","0","0","0","0","0"
"5","ScalarFunction.java","0","0","0","0","0"
"5","StaticMethodInvocationDesc.java","0","0","0","0","0"
"5","UDFInvocationDesc.java","0","0","0","0","0"
"5","TestColumnStat.java","0","0","0","0","0"
"5","TestStatisticsUtil.java","0","0","0","0","0"
"5","TestStatSet.java","0","0","0","0","0"
"5","TestTableStat.java","0","0","0","0","0"
"5","TestCatalogUtil.java","0","0","0","0","0"
"5","TestColumn.java","0","0","0","0","0"
"5","TestFunctionDesc.java","0","0","0","0","0"
"5","TestIndexDesc.java","84059","384589","468648","84059","16811.0"
"5","TestKeyValueSet.java","0","0","0","0","0"
"5","TestSchema.java","0","0","0","0","0"
"5","TestTableDesc.java","0","0","0","0","0"
"5","TestTableMeta.java","76238","419415","495653","113467","22693.0"
"5","HCatalogStore.java","0","0","0","0","0"
"5","HiveCatalogStore.java","116011","373346","489357","155447","31089.0"
"5","HiveCatalogStoreClientPool.java","0","0","0","0","0"
"5","HiveCatalogUtil.java","116011","373346","489357","146543","29308.0"
"5","TestHiveCatalogStore.java","129358","371339","500697","151867","30373.0"
"5","CatalogServer.java","83983","380705","464688","153492","30698.0"
"5","AbstractTableDescriptor.java","0","0","0","0","0"
"5","ClusterTableDescriptor.java","0","0","0","0","0"
"5","ColumnDescriptor.java","0","0","0","0","0"
"5","ColumnsTableDescriptor.java","0","0","0","0","0"
"5","DatabasesTableDescriptor.java","0","0","0","0","0"
"5","IndexesTableDescriptor.java","0","0","0","0","0"
"5","InfoSchemaMetadataDictionary.java","67299","140373","207672","67299","13459.0"
"5","PartitionKeysTableDescriptor.java","0","0","0","0","0"
"5","PartitionsTableDescriptor.java","0","0","0","0","0"
"5","SessionTableDescriptor.java","0","0","0","0","0"
"5","TableDescriptor.java","0","0","0","0","0"
"5","TableOptionsTableDescriptor.java","0","0","0","0","0"
"5","TablespacesTableDescriptor.java","0","0","0","0","0"
"5","TablesTableDescriptor.java","0","0","0","0","0"
"5","TableStatsTableDescriptor.java","0","0","0","0","0"
"5","LinkedMetadataManager.java","109588","120665","230253","109588","21917.0"
"5","LocalCatalogWrapper.java","0","0","0","0","0"
"5","AbstractDBStore.java","148435","356165","504600","156256","31251.0"
"5","CatalogStore.java","83983","380705","464688","144946","28989.0"
"5","DerbyStore.java","103820","383090","486910","141894","28378.0"
"5","MariaDBStore.java","0","0","0","0","0"
"5","MySQLStore.java","0","0","0","0","0"
"5","BaseSchema.java","0","0","0","0","0"
"5","DatabaseObject.java","0","0","0","0","0"
"5","DatabaseObjectType.java","0","0","0","0","0"
"5","SchemaPatch.java","0","0","0","0","0"
"5","SQLObject.java","0","0","0","0","0"
"5","StoreObject.java","0","0","0","0","0"
"5","OracleStore.java","114648","219918","334566","114648","22929.0"
"5","PostgreSQLStore.java","114239","219967","334206","114239","22847.0"
"5","XMLCatalogSchemaManager.java","89878","183496","273374","89878","17975.0"
"5","CatalogTestingUtil.java","3578","4807","8385","3578","715.0"
"5","MiniCatalogServer.java","0","0","0","0","0"
"5","TestXMLCatalogSchemaManager.java","0","0","0","0","0"
"5","TestCatalog.java","84059","384589","468648","153492","30698.0"
"5","TestCatalogAgainstCaseSensitivity.java","4220","26048","30268","4220","844.0"
"5","TestCatalogExceptions.java","3451","24548","27999","3451","690.0"
"5","TestLinkedMetadataManager.java","100438","105248","205686","100438","20087.0"
"5","TajoAdmin.java","131127","362953","494080","153260","30652.0"
"5","TajoDump.java","101062","376143","477205","151146","30229.0"
"5","TajoGetConf.java","0","0","0","0","0"
"5","TajoHAAdmin.java","0","0","0","0","0"
"5","CliClientParamsFactory.java","0","0","0","0","0"
"5","ConnectDatabaseCommand.java","148691","362497","511188","148691","29738.0"
"5","CopyrightCommand.java","0","0","0","0","0"
"5","DescFunctionCommand.java","0","0","0","0","0"
"5","DescTableCommand.java","136417","367194","503611","136417","27283.0"
"5","ExecExternalShellCommand.java","0","0","0","0","0"
"5","ExitCommand.java","0","0","0","0","0"
"5","HdfsCommand.java","0","0","0","0","0"
"5","HelpCommand.java","0","0","0","0","0"
"5","ListDatabaseCommand.java","0","0","0","0","0"
"5","SetCommand.java","148435","356165","504600","148435","29687.0"
"5","TajoAdminCommand.java","0","0","0","0","0"
"5","TajoGetConfCommand.java","0","0","0","0","0"
"5","TajoHAAdminCommand.java","0","0","0","0","0"
"5","TajoShellCommand.java","136652","371836","508488","136652","27330.0"
"5","UnsetCommand.java","0","0","0","0","0"
"5","VersionCommand.java","0","0","0","0","0"
"5","DefaultTajoCliOutputFormatter.java","0","0","0","0","0"
"5","InvalidStatementException.java","0","0","0","0","0"
"5","ParsedResult.java","0","0","0","0","0"
"5","SimpleParser.java","150362","394043","544405","154209","30841.0"
"5","TajoCli.java","83983","381807","465790","152987","30597.0"
"5","TajoCliOutputFormatter.java","0","0","0","0","0"
"5","TajoFileHistory.java","0","0","0","0","0"
"5","CatalogAdminClient.java","85925","189379","275304","85925","17185.0"
"5","CatalogAdminClientImpl.java","83515","183161","266676","83515","16703.0"
"5","ClientParameterHelper.java","0","0","0","0","0"
"5","ClientParameters.java","0","0","0","0","0"
"5","DummyServiceTracker.java","0","0","0","0","0"
"5","InvalidClientSessionException.java","84062","386860","470922","84062","16812.0"
"5","QueryClient.java","87176","195037","282213","87176","17435.0"
"5","QueryClientImpl.java","83515","183161","266676","83515","16703.0"
"5","QueryStatus.java","0","0","0","0","0"
"5","ResultSetUtil.java","128699","377153","505852","133916","26783.0"
"5","SessionConnection.java","83515","183161","266676","83515","16703.0"
"5","TajoClient.java","97990","103158","201148","97990","19598.0"
"5","TajoClientImpl.java","85925","189379","275304","85925","17185.0"
"5","TajoClientUtil.java","85246","185994","271240","85246","17049.0"
"5","ClientDelegate.java","0","0","0","0","0"
"5","ClientDelegateFactory.java","0","0","0","0","0"
"5","ClientUtil.java","0","0","0","0","0"
"5","ClientConnectionException.java","0","0","0","0","0"
"5","ClientUnableToConnectException.java","0","0","0","0","0"
"5","FutureListener.java","0","0","0","0","0"
"5","LegacyClientDelegate.java","3446","5585","9031","3446","689.0"
"5","QueryFuture.java","0","0","0","0","0"
"5","QueryState.java","0","0","0","0","0"
"5","ServiceDiscovery.java","0","0","0","0","0"
"5","TajoClient.java","97990","103158","201148","97990","19598.0"
"5","FetchResultSet.java","146767","269351","416118","146767","29353.0"
"5","MetaDataTuple.java","138836","362903","501739","138836","27767.0"
"5","TajoMemoryResultSet.java","157683","373343","531026","157683","31536.0"
"5","TajoMetaDataResultSet.java","0","0","0","0","0"
"5","TajoResultSetBase.java","119154","413958","533112","147293","29458.0"
"5","TajoResultSetMetaData.java","0","0","0","0","0"
"5","TajoSQLException.java","0","0","0","0","0"
"5","WaitingResultSet.java","0","0","0","0","0"
"5","RowStoreUtil.java","84217","392368","476585","154633","30926.0"
"5","TableExample.java","0","0","0","0","0"
"5","TajoClientAsyncExample.java","0","0","0","0","0"
"5","TajoClientExample.java","0","0","0","0","0"
"5","BackendTestingUtil.java","90361","388943","479304","90361","18072.0"
"5","CatalogTestingUtil.java","3578","4807","8385","3578","715.0"
"5","HBaseTestClusterUtil.java","0","0","0","0","0"
"5","IntegrationTest.java","0","0","0","0","0"
"5","LocalTajoTestingUtility.java","0","0","0","0","0"
"5","NamedTest.java","0","0","0","0","0"
"5","QueryTestCaseBase.java","130862","365270","496132","157067","31413.0"
"5","TajoTestingCluster.java","84320","393358","477678","147333","29466.0"
"5","TpchTestBase.java","84219","392901","477120","84219","16843.0"
"5","NotNull.java","0","0","0","0","0"
"5","NotThreadSafe.java","0","0","0","0","0"
"5","Nullable.java","0","0","0","0","0"
"5","ThreadSafe.java","0","0","0","0","0"
"5","Assert.java","0","0","0","0","0"
"5","UserRoleInfo.java","0","0","0","0","0"
"5","BuiltinStorages.java","0","0","0","0","0"
"5","ProtoObject.java","0","0","0","0","0"
"5","Sleeper.java","0","0","0","0","0"
"5","IPv4.java","0","0","0","0","0"
"5","TajoTypeUtil.java","0","0","0","0","0"
"5","TimeRange.java","0","0","0","0","0"
"5","TajoConf.java","81801","177931","259732","119764","23952.0"
"5","ConfigKey.java","0","0","0","0","0"
"5","AnyDatum.java","0","0","0","0","0"
"5","BitDatum.java","0","0","0","0","0"
"5","BlobDatum.java","0","0","0","0","0"
"5","BooleanDatum.java","0","0","0","0","0"
"5","CharDatum.java","0","0","0","0","0"
"5","DateDatum.java","127349","400646","527995","155867","31173.0"
"5","Datum.java","131844","399778","531622","131844","26368.0"
"5","DatumFactory.java","90955","181923","272878","135686","27137.0"
"5","Float4Datum.java","0","0","0","0","0"
"5","Float8Datum.java","0","0","0","0","0"
"5","Int2Datum.java","0","0","0","0","0"
"5","Int4Datum.java","0","0","0","0","0"
"5","Int8Datum.java","0","0","0","0","0"
"5","IntervalDatum.java","0","0","0","0","0"
"5","NullDatum.java","0","0","0","0","0"
"5","NumericDatum.java","0","0","0","0","0"
"5","AbstractCharBasedFormatter.java","0","0","0","0","0"
"5","ProtobufFormatter.java","0","0","0","0","0"
"5","ProtobufJsonFormat.java","0","0","0","0","0"
"5","TextUtils.java","0","0","0","0","0"
"5","ProtobufDatum.java","0","0","0","0","0"
"5","ProtobufDatumFactory.java","98160","405035","503195","98160","19632.0"
"5","TextDatum.java","0","0","0","0","0"
"5","TimeDatum.java","0","0","0","0","0"
"5","TimestampDatum.java","126423","383133","509556","136406","27281.0"
"5","AmbiguousColumnException.java","0","0","0","0","0"
"5","AmbiguousFunctionException.java","3446","5585","9031","3446","689.0"
"5","AmbiguousPartitionDirectoryExistException.java","24737","27752","52489","24737","4947.0"
"5","AmbiguousTableException.java","0","0","0","0","0"
"5","CannotDropCurrentDatabaseException.java","84547","420781","505328","84547","16909.0"
"5","CatalogUpgradeRequiredException.java","84208","389145","473353","84208","16841.0"
"5","DataTypeMismatchException.java","84062","386860","470922","84062","16812.0"
"5","DefaultTajoException.java","84208","389145","473353","84208","16841.0"
"5","DividedByZeroException.java","84547","420781","505328","84547","16909.0"
"5","DuplicateColumnException.java","83983","380705","464688","83983","16796.0"
"5","DuplicateDatabaseException.java","83983","380705","464688","83983","16796.0"
"5","DuplicateFunctionException.java","84062","386860","470922","84062","16812.0"
"5","DuplicateIndexException.java","84208","389145","473353","84208","16841.0"
"5","DuplicatePartitionException.java","84208","389145","473353","84208","16841.0"
"5","DuplicateTableException.java","84208","389145","473353","84208","16841.0"
"5","DuplicateTablespaceException.java","83983","380705","464688","83983","16796.0"
"5","ErrorMessages.java","1011","1614","2625","1011","202.0"
"5","ErrorUtil.java","0","0","0","0","0"
"5","ExceptionUtil.java","11470","19685","31155","11470","2294.0"
"5","InsufficientPrivilegeException.java","3254","3963","7217","3254","650.0"
"5","InvalidAddressException.java","0","0","0","0","0"
"5","InvalidDataTypeException.java","114440","374153","488593","114440","22888.0"
"5","InvalidInputsForCrossJoin.java","0","0","0","0","0"
"5","InvalidNameException.java","83983","380705","464688","83983","16796.0"
"5","InvalidOperationException.java","0","0","0","0","0"
"5","InvalidSessionException.java","84062","386860","470922","84062","16812.0"
"5","InvalidSessionVariableException.java","84547","420781","505328","84547","16909.0"
"5","InvalidTablePropertyException.java","84062","386860","470922","84062","16812.0"
"5","InvalidURLException.java","84547","420781","505328","84547","16909.0"
"5","InvalidValueForCastException.java","84377","410628","495005","84377","16875.0"
"5","LMDNoMatchedDatatypeException.java","84062","386860","470922","84062","16812.0"
"5","MetadataConnectionException.java","83983","380705","464688","83983","16796.0"
"5","MissingTablePropertyException.java","84062","386860","470922","84062","16812.0"
"5","NoSuchSessionVariableException.java","83983","380705","464688","83983","16796.0"
"5","NotImplementedException.java","0","0","0","0","0"
"5","QueryFailedException.java","84062","386860","470922","84062","16812.0"
"5","QueryKilledException.java","84062","386860","470922","84062","16812.0"
"5","QueryNotFoundException.java","84062","386860","470922","84062","16812.0"
"5","ReturnStateUtil.java","7595","11403","18998","7595","1519.0"
"5","SQLExceptionUtil.java","8785","14861","23646","8785","1757.0"
"5","SQLSyntaxError.java","0","0","0","0","0"
"5","TajoError.java","8785","14861","23646","8785","1757.0"
"5","TajoException.java","8785","14861","23646","8785","1757.0"
"5","TajoInternalError.java","114440","374153","488593","114440","22888.0"
"5","TajoRuntimeException.java","1011","1614","2625","1011","202.0"
"5","TooLargeInputForCrossJoinException.java","0","0","0","0","0"
"5","UnavailableTableLocationException.java","84062","386860","470922","84062","16812.0"
"5","UndefinedColumnException.java","83983","380705","464688","83983","16796.0"
"5","UndefinedDatabaseException.java","83983","380705","464688","83983","16796.0"
"5","UndefinedFunctionException.java","84062","386860","470922","84062","16812.0"
"5","UndefinedIndexException.java","83983","380705","464688","83983","16796.0"
"5","UndefinedOperatorException.java","114440","374153","488593","114440","22888.0"
"5","UndefinedPartitionException.java","0","0","0","0","0"
"5","UndefinedPartitionKeyException.java","24737","27752","52489","24737","4947.0"
"5","UndefinedPartitionMethodException.java","24737","27752","52489","24737","4947.0"
"5","UndefinedTableException.java","83983","380705","464688","83983","16796.0"
"5","UndefinedTablespaceException.java","83983","380705","464688","83983","16796.0"
"5","UndefinedTablespaceHandlerException.java","0","0","0","0","0"
"5","UnknownDataFormatException.java","84062","386860","470922","84062","16812.0"
"5","UnremovableTablePropertyException.java","0","0","0","0","0"
"5","UnsupportedCatalogStore.java","0","0","0","0","0"
"5","UnsupportedDataTypeException.java","84208","389145","473353","84208","16841.0"
"5","UnsupportedException.java","0","0","0","0","0"
"5","ValueOutOfRangeException.java","0","0","0","0","0"
"5","ValueTooLongForTypeCharactersException.java","0","0","0","0","0"
"5","ExecutionBlockId.java","0","0","0","0","0"
"5","HAConstants.java","0","0","0","0","0"
"5","ClassNameSerializer.java","0","0","0","0","0"
"5","CommonGsonHelper.java","0","0","0","0","0"
"5","DataTypeAdapter.java","0","0","0","0","0"
"5","DatumAdapter.java","0","0","0","0","0"
"5","GsonHelper.java","0","0","0","0","0"
"5","GsonObject.java","0","0","0","0","0"
"5","GsonSerDerAdapter.java","0","0","0","0","0"
"5","PathSerializer.java","0","0","0","0","0"
"5","TimeZoneGsonSerdeAdapter.java","0","0","0","0","0"
"5","TypeAdapter.java","0","0","0","0","0"
"5","OverridableConf.java","0","0","0","0","0"
"5","QueryId.java","0","0","0","0","0"
"5","QueryIdFactory.java","0","0","0","0","0"
"5","QueryVars.java","0","0","0","0","0"
"5","BaseRuleProvider.java","0","0","0","0","0"
"5","CheckHadoopRuntimeVersionRule.java","0","0","0","0","0"
"5","TajoConfValidationRule.java","0","0","0","0","0"
"5","EvaluationContext.java","0","0","0","0","0"
"5","EvaluationFailedException.java","0","0","0","0","0"
"5","EvaluationResult.java","0","0","0","0","0"
"5","SelfDiagnosisRule.java","0","0","0","0","0"
"5","SelfDiagnosisRuleDefinition.java","0","0","0","0","0"
"5","SelfDiagnosisRuleEngine.java","0","0","0","0","0"
"5","SelfDiagnosisRuleProvider.java","0","0","0","0","0"
"5","SelfDiagnosisRuleSession.java","0","0","0","0","0"
"5","SelfDiagnosisRuleVisibility.java","0","0","0","0","0"
"5","ANSISQLIdentifierPolicy.java","0","0","0","0","0"
"5","Field.java","0","0","0","0","0"
"5","Identifier.java","0","0","0","0","0"
"5","IdentifierPolicy.java","0","0","0","0","0"
"5","IdentifierUtil.java","0","0","0","0","0"
"5","package-info.java","0","0","0","0","0"
"5","PgSQLIdentifierPolicy.java","0","0","0","0","0"
"5","QualifiedIdentifier.java","0","0","0","0","0"
"5","Schema.java","0","0","0","0","0"
"5","TajoIdentifierPolicy.java","0","0","0","0","0"
"5","BaseServiceTracker.java","0","0","0","0","0"
"5","HAServiceTracker.java","0","0","0","0","0"
"5","ServiceTracker.java","0","0","0","0","0"
"5","ServiceTrackerException.java","0","0","0","0","0"
"5","ServiceTrackerFactory.java","0","0","0","0","0"
"5","TajoMasterInfo.java","0","0","0","0","0"
"5","SessionVars.java","106242","271522","377764","106242","21248.0"
"5","BufferPool.java","87743","149076","236819","87743","17548.0"
"5","EmptyTuple.java","0","0","0","0","0"
"5","NullTuple.java","31147","77687","108834","31147","6229.0"
"5","StorageConstants.java","158960","384602","543562","158960","31792.0"
"5","Tuple.java","83983","381677","465660","135023","27004.0"
"5","VTuple.java","83983","381677","465660","137868","27573.0"
"5","TajoConstants.java","84547","420781","505328","84547","16909.0"
"5","TaskAttemptId.java","0","0","0","0","0"
"5","TaskId.java","81370","379915","461285","82703","16540.0"
"5","BaseTupleBuilder.java","7397","11849","19246","7397","1479.0"
"5","CompactRowBlockWriter.java","1906","2605","4511","1906","381.0"
"5","DirectBufTuple.java","120694","228204","348898","120694","24138.0"
"5","FixedSizeLimitSpec.java","0","0","0","0","0"
"5","HeapRowBlockReader.java","0","0","0","0","0"
"5","HeapTuple.java","86693","182141","268834","86693","17338.0"
"5","MemoryBlock.java","0","0","0","0","0"
"5","MemoryRowBlock.java","13995","43228","57223","13995","2799.0"
"5","OffHeapRowBlockReader.java","0","0","0","0","0"
"5","OffHeapRowBlockUtils.java","13995","43228","57223","13995","2799.0"
"5","OffHeapRowBlockWriter.java","120694","228204","348898","120694","24138.0"
"5","OffHeapRowWriter.java","0","0","0","0","0"
"5","ResizableLimitSpec.java","127071","263814","390885","127071","25414.0"
"5","ResizableMemoryBlock.java","15702","45634","61336","15702","3140.0"
"5","RowBlock.java","13995","43228","57223","13995","2799.0"
"5","RowWriter.java","120694","228204","348898","120694","24138.0"
"5","UnSafeTuple.java","86693","182141","268834","86693","17338.0"
"5","UnSafeTupleBytesComparator.java","0","0","0","0","0"
"5","UnSafeTupleList.java","0","0","0","0","0"
"5","ZeroCopyTuple.java","0","0","0","0","0"
"5","RowBlockReader.java","0","0","0","0","0"
"5","TupleBuilder.java","0","0","0","0","0"
"5","Any.java","0","0","0","0","0"
"5","Array.java","0","0","0","0","0"
"5","Bit.java","0","0","0","0","0"
"5","Blob.java","0","0","0","0","0"
"5","Bool.java","0","0","0","0","0"
"5","Char.java","0","0","0","0","0"
"5","Date.java","0","0","0","0","0"
"5","Float4.java","0","0","0","0","0"
"5","Float8.java","0","0","0","0","0"
"5","Int1.java","0","0","0","0","0"
"5","Int2.java","0","0","0","0","0"
"5","Int4.java","0","0","0","0","0"
"5","Int8.java","0","0","0","0","0"
"5","Interval.java","0","0","0","0","0"
"5","Map.java","0","0","0","0","0"
"5","Null.java","0","0","0","0","0"
"5","Numeric.java","0","0","0","0","0"
"5","package-info.java","0","0","0","0","0"
"5","Protobuf.java","0","0","0","0","0"
"5","Record.java","0","0","0","0","0"
"5","Text.java","0","0","0","0","0"
"5","Time.java","0","0","0","0","0"
"5","Timestamp.java","0","0","0","0","0"
"5","Type.java","0","0","0","0","0"
"5","TypeFactory.java","0","0","0","0","0"
"5","TypeParamterizedType.java","0","0","0","0","0"
"5","TypeProtobufEncoder.java","0","0","0","0","0"
"5","TypeStringEncoder.java","0","0","0","0","0"
"5","TypeVisitor.java","0","0","0","0","0"
"5","ValueParamterizedType.java","0","0","0","0","0"
"5","Varchar.java","0","0","0","0","0"
"5","StorageUnit.java","0","0","0","0","0"
"5","TimeUnit.java","0","0","0","0","0"
"5","BasicFuture.java","0","0","0","0","0"
"5","BitArray.java","0","0","0","0","0"
"5","Bytes.java","0","0","0","0","0"
"5","BytesUtils.java","105750","278196","383946","105750","21150.0"
"5","ClassSize.java","0","0","0","0","0"
"5","ClassUtil.java","0","0","0","0","0"
"5","CommonTestingUtil.java","0","0","0","0","0"
"5","CompressionUtil.java","0","0","0","0","0"
"5","DateTimeConstants.java","0","0","0","0","0"
"5","DateTimeFormat.java","0","0","0","0","0"
"5","DateTimeUtil.java","0","0","0","0","0"
"5","TimeMeta.java","0","0","0","0","0"
"5","Deallocatable.java","0","0","0","0","0"
"5","FileUtil.java","0","0","0","0","0"
"5","DirectedGraph.java","0","0","0","0","0"
"5","DirectedGraphCursor.java","0","0","0","0","0"
"5","DirectedGraphVisitor.java","0","0","0","0","0"
"5","Graph.java","0","0","0","0","0"
"5","SimpleDirectedGraph.java","92496","378963","471459","92496","18499.0"
"5","SimpleUndirectedGraph.java","0","0","0","0","0"
"5","UndirectedGraph.java","0","0","0","0","0"
"5","JarUtil.java","0","0","0","0","0"
"5","JavaResourceUtil.java","0","0","0","0","0"
"5","KeyValueSet.java","84572","421626","506198","140826","28165.0"
"5","MurmurHash.java","0","0","0","0","0"
"5","NetUtils.java","0","0","0","0","0"
"5","NumberUtil.java","85134","170265","255399","90433","18086.0"
"5","Pair.java","103326","262115","365441","116462","23292.0"
"5","PlatformUtil.java","0","0","0","0","0"
"5","ProtoUtil.java","0","0","0","0","0"
"5","ReflectionUtil.java","0","0","0","0","0"
"5","ShutdownHookManager.java","0","0","0","0","0"
"5","SizeOf.java","0","0","0","0","0"
"5","StringUtils.java","99598","290784","390382","155005","31001.0"
"5","TajoIdUtils.java","0","0","0","0","0"
"5","TUtil.java","84572","421626","506198","139386","27877.0"
"5","UnsafeComparer.java","0","0","0","0","0"
"5","UnsafeUtil.java","0","0","0","0","0"
"5","UriUtil.java","0","0","0","0","0"
"5","VersionInfo.java","0","0","0","0","0"
"5","AbstractValidator.java","0","0","0","0","0"
"5","BooleanValidator.java","0","0","0","0","0"
"5","ClassValidator.java","0","0","0","0","0"
"5","ConstraintViolation.java","0","0","0","0","0"
"5","ConstraintViolationException.java","0","0","0","0","0"
"5","GroupValidator.java","0","0","0","0","0"
"5","JavaStringValidator.java","0","0","0","0","0"
"5","LengthValidator.java","0","0","0","0","0"
"5","MaxValidator.java","0","0","0","0","0"
"5","MinValidator.java","0","0","0","0","0"
"5","NetworkAddressValidator.java","0","0","0","0","0"
"5","NotNullValidator.java","0","0","0","0","0"
"5","PathListValidator.java","0","0","0","0","0"
"5","PathValidator.java","0","0","0","0","0"
"5","PatternValidator.java","0","0","0","0","0"
"5","RangeValidator.java","0","0","0","0","0"
"5","ShellVariableValidator.java","0","0","0","0","0"
"5","Validator.java","0","0","0","0","0"
"5","Validators.java","0","0","0","0","0"
"5","TestIPv4.java","0","0","0","0","0"
"5","TestTimeRange.java","0","0","0","0","0"
"5","TestProtobufDatum.java","0","0","0","0","0"
"5","TestTextUtils.java","0","0","0","0","0"
"5","TestArithmeticOperator.java","0","0","0","0","0"
"5","TestBitDatum.java","0","0","0","0","0"
"5","TestBoolDatum.java","0","0","0","0","0"
"5","TestBytesDatum.java","0","0","0","0","0"
"5","TestCharDatum.java","0","0","0","0","0"
"5","TestDateDatum.java","0","0","0","0","0"
"5","TestDatum.java","0","0","0","0","0"
"5","TestDatumFactory.java","0","0","0","0","0"
"5","TestFloat8Datum.java","0","0","0","0","0"
"5","TestFloatDatum.java","0","0","0","0","0"
"5","TestInt2Datum.java","0","0","0","0","0"
"5","TestInt4Datum.java","0","0","0","0","0"
"5","TestInt8Datum.java","0","0","0","0","0"
"5","TestIntervalDatum.java","0","0","0","0","0"
"5","TestTextDatum.java","0","0","0","0","0"
"5","TestTimeDatum.java","0","0","0","0","0"
"5","TestTimestampDatum.java","0","0","0","0","0"
"5","TestRuleEngine.java","0","0","0","0","0"
"5","TestRuleSession.java","0","0","0","0","0"
"5","TestANSISQLIdentifierPolicy.java","0","0","0","0","0"
"5","TestIdentifier.java","0","0","0","0","0"
"5","TestSchema.java","0","0","0","0","0"
"5","TestTajoIdentifierPolicy.java","0","0","0","0","0"
"5","TestHeapTuple.java","0","0","0","0","0"
"5","TestMemoryRowBlock.java","120694","228204","348898","120694","24138.0"
"5","TestResizableSpec.java","0","0","0","0","0"
"5","TestUnSafeTupleBytesComparator.java","0","0","0","0","0"
"5","TestBaseTupleBuilder.java","0","0","0","0","0"
"5","TestType.java","0","0","0","0","0"
"5","TestTypeEncoder.java","0","0","0","0","0"
"5","TestTypeProtobufEncoder.java","0","0","0","0","0"
"5","TestTypeStringEncoder.java","0","0","0","0","0"
"5","TestSimpleDirectedGraph.java","92060","377794","469854","99626","19925.0"
"5","TestSimpleUndirectedGraph.java","0","0","0","0","0"
"5","TestBitArrayTest.java","0","0","0","0","0"
"5","TestDateTimeFormat.java","0","0","0","0","0"
"5","TestDateTimeUtil.java","0","0","0","0","0"
"5","TestNumberUtil.java","0","0","0","0","0"
"5","TestStringUtil.java","0","0","0","0","0"
"5","TestUriUtil.java","0","0","0","0","0"
"5","TestValidators.java","124922","267769","392691","124922","24984.0"
"5","BenchmarkSet.java","84320","393358","477678","113977","22795.0"
"5","Driver.java","0","0","0","0","0"
"5","SimpleQuery.java","0","0","0","0","0"
"5","TPCH.java","83983","380705","464688","119650","23930.0"
"5","CaseWhenEmitter.java","0","0","0","0","0"
"5","CaseWhenSwitchGenerator.java","0","0","0","0","0"
"5","CodeGenUtils.java","0","0","0","0","0"
"5","CompilationError.java","0","0","0","0","0"
"5","EvalCodeEmitter.java","0","0","0","0","0"
"5","EvalCodeGenContext.java","0","0","0","0","0"
"5","EvalCodeGenerator.java","0","0","0","0","0"
"5","ExecutorPreCompiler.java","85037","186115","271152","85037","17007.0"
"5","LegacyFunctionBindingEmitter.java","0","0","0","0","0"
"5","ScalarFunctionBindingEmitter.java","0","0","0","0","0"
"5","TajoClassLoader.java","0","0","0","0","0"
"5","TajoGeneratorAdapter.java","0","0","0","0","0"
"5","VariablesPreBuilder.java","0","0","0","0","0"
"5","RangeOverflowException.java","0","0","0","0","0"
"5","Description.java","0","0","0","0","0"
"5","ParamOptionTypes.java","0","0","0","0","0"
"5","ParamTypes.java","0","0","0","0","0"
"5","AvgDouble.java","0","0","0","0","0"
"5","AvgFloat.java","0","0","0","0","0"
"5","AvgInt.java","0","0","0","0","0"
"5","AvgLong.java","0","0","0","0","0"
"5","Coalesce.java","0","0","0","0","0"
"5","CoalesceBoolean.java","0","0","0","0","0"
"5","CoalesceDate.java","0","0","0","0","0"
"5","CoalesceDouble.java","0","0","0","0","0"
"5","CoalesceLong.java","0","0","0","0","0"
"5","CoalesceString.java","0","0","0","0","0"
"5","CoalesceTime.java","0","0","0","0","0"
"5","CoalesceTimestamp.java","0","0","0","0","0"
"5","Corr.java","0","0","0","0","0"
"5","CountRows.java","0","0","0","0","0"
"5","CountValue.java","0","0","0","0","0"
"5","CountValueDistinct.java","0","0","0","0","0"
"5","Date.java","0","0","0","0","0"
"5","LastValue.java","0","0","0","0","0"
"5","LastValueDate.java","0","0","0","0","0"
"5","LastValueDouble.java","0","0","0","0","0"
"5","LastValueFloat.java","0","0","0","0","0"
"5","LastValueInt.java","0","0","0","0","0"
"5","LastValueLong.java","0","0","0","0","0"
"5","LastValueString.java","0","0","0","0","0"
"5","LastValueTime.java","0","0","0","0","0"
"5","LastValueTimestamp.java","0","0","0","0","0"
"5","Lead.java","100026","202719","302745","100026","20005.0"
"5","LeadDate.java","0","0","0","0","0"
"5","LeadDouble.java","0","0","0","0","0"
"5","LeadFloat.java","0","0","0","0","0"
"5","LeadInt.java","0","0","0","0","0"
"5","LeadLong.java","0","0","0","0","0"
"5","LeadString.java","0","0","0","0","0"
"5","LeadTime.java","0","0","0","0","0"
"5","LeadTimestamp.java","0","0","0","0","0"
"5","Max.java","0","0","0","0","0"
"5","MaxDate.java","0","0","0","0","0"
"5","MaxDouble.java","0","0","0","0","0"
"5","MaxFloat.java","0","0","0","0","0"
"5","MaxInt.java","0","0","0","0","0"
"5","MaxLong.java","0","0","0","0","0"
"5","MaxString.java","0","0","0","0","0"
"5","MaxTime.java","0","0","0","0","0"
"5","MaxTimestamp.java","0","0","0","0","0"
"5","Min.java","0","0","0","0","0"
"5","MinDate.java","0","0","0","0","0"
"5","MinDouble.java","0","0","0","0","0"
"5","MinFloat.java","0","0","0","0","0"
"5","MinInt.java","0","0","0","0","0"
"5","MinLong.java","0","0","0","0","0"
"5","MinString.java","0","0","0","0","0"
"5","MinTime.java","0","0","0","0","0"
"5","MinTimestamp.java","0","0","0","0","0"
"5","RandomInt.java","0","0","0","0","0"
"5","Sleep.java","0","0","0","0","0"
"5","StdDevPop.java","0","0","0","0","0"
"5","StdDevPopDouble.java","0","0","0","0","0"
"5","StdDevPopFloat.java","0","0","0","0","0"
"5","StdDevPopInt.java","0","0","0","0","0"
"5","StdDevPopLong.java","0","0","0","0","0"
"5","StdDevSamp.java","0","0","0","0","0"
"5","StdDevSampDouble.java","0","0","0","0","0"
"5","StdDevSampFloat.java","0","0","0","0","0"
"5","StdDevSampInt.java","0","0","0","0","0"
"5","StdDevSampLong.java","0","0","0","0","0"
"5","StringAgg.java","0","0","0","0","0"
"5","SumDouble.java","0","0","0","0","0"
"5","SumDoubleDistinct.java","0","0","0","0","0"
"5","SumFloat.java","0","0","0","0","0"
"5","SumFloatDistinct.java","0","0","0","0","0"
"5","SumInt.java","0","0","0","0","0"
"5","SumIntDistinct.java","0","0","0","0","0"
"5","SumLong.java","0","0","0","0","0"
"5","SumLongDistinct.java","0","0","0","0","0"
"5","Variance.java","0","0","0","0","0"
"5","VarPop.java","0","0","0","0","0"
"5","VarPopDouble.java","0","0","0","0","0"
"5","VarPopFloat.java","0","0","0","0","0"
"5","VarPopInt.java","0","0","0","0","0"
"5","VarPopLong.java","0","0","0","0","0"
"5","VarSamp.java","0","0","0","0","0"
"5","VarSampDouble.java","0","0","0","0","0"
"5","VarSampFloat.java","0","0","0","0","0"
"5","VarSampInt.java","0","0","0","0","0"
"5","VarSampLong.java","0","0","0","0","0"
"5","AddDays.java","0","0","0","0","0"
"5","AddMonths.java","0","0","0","0","0"
"5","CurrentDate.java","0","0","0","0","0"
"5","CurrentTime.java","0","0","0","0","0"
"5","DatePartFromDate.java","0","0","0","0","0"
"5","DatePartFromTime.java","0","0","0","0","0"
"5","DatePartFromTimestamp.java","0","0","0","0","0"
"5","DateTimePartFromUnixTimestamp.java","0","0","0","0","0"
"5","NowTimestamp.java","0","0","0","0","0"
"5","ToCharTimestamp.java","0","0","0","0","0"
"5","ToDate.java","0","0","0","0","0"
"5","ToTimestampInt.java","0","0","0","0","0"
"5","ToTimestampText.java","0","0","0","0","0"
"5","FailFunction.java","0","0","0","0","0"
"5","FunctionLoader.java","143513","253400","396913","143513","28702.0"
"5","BlobToIPstr.java","0","0","0","0","0"
"5","GeoIPCountryBlob.java","0","0","0","0","0"
"5","GeoIPCountryInt.java","0","0","0","0","0"
"5","GeoIPCountryText.java","0","0","0","0","0"
"5","GeoIPInCountryBlob.java","0","0","0","0","0"
"5","GeoIPInCountryInt.java","0","0","0","0","0"
"5","GeoIPInCountryText.java","0","0","0","0","0"
"5","IntToIPstr.java","0","0","0","0","0"
"5","IPstrToBlob.java","0","0","0","0","0"
"5","IPstrToInt.java","0","0","0","0","0"
"5","HiveFunctionLoader.java","0","0","0","0","0"
"5","JsonArrayContains.java","0","0","0","0","0"
"5","JsonArrayGet.java","0","0","0","0","0"
"5","JsonArrayLength.java","0","0","0","0","0"
"5","JsonExtractPathText.java","0","0","0","0","0"
"5","ScalarJsonFunction.java","0","0","0","0","0"
"5","AbsDouble.java","0","0","0","0","0"
"5","AbsFloat.java","0","0","0","0","0"
"5","AbsInt.java","0","0","0","0","0"
"5","AbsLong.java","0","0","0","0","0"
"5","Acos.java","0","0","0","0","0"
"5","Asin.java","0","0","0","0","0"
"5","Atan.java","0","0","0","0","0"
"5","Atan2.java","0","0","0","0","0"
"5","Cbrt.java","0","0","0","0","0"
"5","Ceil.java","0","0","0","0","0"
"5","Cos.java","0","0","0","0","0"
"5","Degrees.java","0","0","0","0","0"
"5","Div.java","0","0","0","0","0"
"5","Exp.java","0","0","0","0","0"
"5","Floor.java","0","0","0","0","0"
"5","MathFunctions.java","0","0","0","0","0"
"5","Mod.java","0","0","0","0","0"
"5","Pi.java","0","0","0","0","0"
"5","Pow.java","0","0","0","0","0"
"5","Radians.java","0","0","0","0","0"
"5","Round.java","0","0","0","0","0"
"5","RoundFloat8.java","0","0","0","0","0"
"5","Sign.java","0","0","0","0","0"
"5","Sin.java","0","0","0","0","0"
"5","Sqrt.java","0","0","0","0","0"
"5","Tan.java","0","0","0","0","0"
"5","Ascii.java","0","0","0","0","0"
"5","BitLength.java","0","0","0","0","0"
"5","BTrim.java","0","0","0","0","0"
"5","CharLength.java","0","0","0","0","0"
"5","Chr.java","0","0","0","0","0"
"5","Concat.java","0","0","0","0","0"
"5","Concat_ws.java","0","0","0","0","0"
"5","Decode.java","0","0","0","0","0"
"5","Digest.java","0","0","0","0","0"
"5","Encode.java","0","0","0","0","0"
"5","FindInSet.java","0","0","0","0","0"
"5","HexStringConverter.java","0","0","0","0","0"
"5","InitCap.java","0","0","0","0","0"
"5","Left.java","0","0","0","0","0"
"5","Length.java","0","0","0","0","0"
"5","Locate.java","0","0","0","0","0"
"5","Lower.java","0","0","0","0","0"
"5","Lpad.java","0","0","0","0","0"
"5","LTrim.java","0","0","0","0","0"
"5","Md5.java","0","0","0","0","0"
"5","OctetLength.java","0","0","0","0","0"
"5","QuoteIdent.java","0","0","0","0","0"
"5","RegexpReplace.java","0","0","0","0","0"
"5","Repeat.java","0","0","0","0","0"
"5","Reverse.java","0","0","0","0","0"
"5","Right.java","0","0","0","0","0"
"5","Rpad.java","0","0","0","0","0"
"5","RTrim.java","0","0","0","0","0"
"5","SplitPart.java","0","0","0","0","0"
"5","StrPos.java","0","0","0","0","0"
"5","StrPosb.java","0","0","0","0","0"
"5","Substr.java","0","0","0","0","0"
"5","ToBin.java","0","0","0","0","0"
"5","ToCharLong.java","0","0","0","0","0"
"5","ToHex.java","0","0","0","0","0"
"5","Upper.java","0","0","0","0","0"
"5","FirstValue.java","0","0","0","0","0"
"5","FirstValueDate.java","0","0","0","0","0"
"5","FirstValueDouble.java","0","0","0","0","0"
"5","FirstValueFloat.java","0","0","0","0","0"
"5","FirstValueInt.java","0","0","0","0","0"
"5","FirstValueLong.java","0","0","0","0","0"
"5","FirstValueString.java","0","0","0","0","0"
"5","FirstValueTime.java","0","0","0","0","0"
"5","FirstValueTimestamp.java","0","0","0","0","0"
"5","Lag.java","0","0","0","0","0"
"5","LagDate.java","0","0","0","0","0"
"5","LagDouble.java","0","0","0","0","0"
"5","LagFloat.java","0","0","0","0","0"
"5","LagInt.java","0","0","0","0","0"
"5","LagLong.java","0","0","0","0","0"
"5","LagString.java","0","0","0","0","0"
"5","LagTime.java","0","0","0","0","0"
"5","LagTimestamp.java","0","0","0","0","0"
"5","Rank.java","0","0","0","0","0"
"5","RowNumber.java","0","0","0","0","0"
"5","CoreGsonHelper.java","0","0","0","0","0"
"5","Enforcer.java","92265","375743","468008","112800","22560.0"
"5","DistinctGroupbyBuilder.java","128510","349755","478265","128510","25702.0"
"5","DataChannel.java","93099","418346","511445","130530","26106.0"
"5","ExecutionBlock.java","0","0","0","0","0"
"5","ExecutionBlockCursor.java","84547","417220","501767","94949","18989.0"
"5","ExecutionQueue.java","0","0","0","0","0"
"5","GlobalPlanner.java","83983","381308","465291","141410","28282.0"
"5","MasterPlan.java","0","0","0","0","0"
"5","ParallelExecutionQueue.java","127186","171988","299174","127186","25437.0"
"5","BaseGlobalPlanRewriteRuleProvider.java","0","0","0","0","0"
"5","GlobalPlanRewriteEngine.java","110986","221786","332772","110986","22197.0"
"5","GlobalPlanRewriteRule.java","0","0","0","0","0"
"5","GlobalPlanRewriteRuleProvider.java","0","0","0","0","0"
"5","GlobalPlanTestRuleProvider.java","0","0","0","0","0"
"5","BroadcastJoinRule.java","116525","133066","249591","116525","23305.0"
"5","GlobalPlanEqualityTester.java","0","0","0","0","0"
"5","GlobalPlanRewriteUtil.java","0","0","0","0","0"
"5","KeyProjector.java","0","0","0","0","0"
"5","AggregationExec.java","0","0","0","0","0"
"5","BasicPhysicalExecutorVisitor.java","92755","391124","483879","92755","18551.0"
"5","BinaryPhysicalExec.java","0","0","0","0","0"
"5","BSTIndexScanExec.java","83983","381677","465660","141628","28325.0"
"5","ColPartitionStoreExec.java","137231","366971","504202","137231","27446.0"
"5","CommonHashJoinExec.java","31147","77687","108834","31147","6229.0"
"5","CommonJoinExec.java","31147","77687","108834","31147","6229.0"
"5","ComparableVector.java","84967","154628","239595","84967","16993.0"
"5","DistinctGroupbyFirstAggregationExec.java","111591","213498","325089","111591","22318.0"
"5","DistinctGroupbyHashAggregationExec.java","100467","286733","387200","100467","20093.0"
"5","DistinctGroupbySecondAggregationExec.java","111591","213498","325089","111591","22318.0"
"5","DistinctGroupbySortAggregationExec.java","129074","355494","484568","129074","25814.0"
"5","DistinctGroupbyThirdAggregationExec.java","111591","213498","325089","111591","22318.0"
"5","EmptyScanIterator.java","0","0","0","0","0"
"5","EvalExprExec.java","84576","423658","508234","142650","28530.0"
"5","ExternalSortExec.java","138836","362903","501739","141625","28325.0"
"5","FilterScanIterator.java","0","0","0","0","0"
"5","FullScanIterator.java","0","0","0","0","0"
"5","HashAggregateExec.java","83983","381677","465660","128475","25695.0"
"5","HashBasedColPartitionStoreExec.java","137127","363311","500438","137127","27425.0"
"5","HashFullOuterJoinExec.java","97986","378575","476561","135904","27180.0"
"5","HashJoinExec.java","84220","393694","477914","84220","16844.0"
"5","HashLeftAntiJoinExec.java","0","0","0","0","0"
"5","HashLeftOuterJoinExec.java","97986","378575","476561","97986","19597.0"
"5","HashLeftSemiJoinExec.java","80472","379632","460104","102145","20429.0"
"5","HashPartitioner.java","0","0","0","0","0"
"5","HashShuffleFileWriteExec.java","84576","423565","508141","138616","27723.0"
"5","HavingExec.java","0","0","0","0","0"
"5","IndexExecutorUtil.java","0","0","0","0","0"
"5","InsertRowsExec.java","0","0","0","0","0"
"5","JoinTupleComparator.java","0","0","0","0","0"
"5","KeyTuple.java","2685","2841","5526","2685","537.0"
"5","LimitExec.java","0","0","0","0","0"
"5","MergeFullOuterJoinExec.java","97986","378575","476561","139955","27991.0"
"5","MergeJoinExec.java","83983","381677","465660","83983","16796.0"
"5","Partitioner.java","0","0","0","0","0"
"5","PartitionMergeScanExec.java","139917","375281","515198","142890","28578.0"
"5","PhysicalExec.java","0","0","0","0","0"
"5","PhysicalExecutorVisitor.java","0","0","0","0","0"
"5","PhysicalPlanUtil.java","124121","264226","388347","133816","26763.0"
"5","ProjectionExec.java","0","0","0","0","0"
"5","RadixSort.java","0","0","0","0","0"
"5","RangeShuffleFileWriteExec.java","83983","381677","465660","134647","26929.0"
"5","RightOuterMergeJoinExec.java","97986","378575","476561","139225","27845.0"
"5","ScanExec.java","0","0","0","0","0"
"5","ScanIterator.java","0","0","0","0","0"
"5","SelectionExec.java","0","0","0","0","0"
"5","SeqScanExec.java","84322","398530","482852","154634","30926.0"
"5","SetTupleComparator.java","0","0","0","0","0"
"5","SortAggregateExec.java","83983","381677","465660","128475","25695.0"
"5","SortBasedColPartitionStoreExec.java","137127","363311","500438","137127","27425.0"
"5","SortExec.java","0","0","0","0","0"
"5","SortIntersectExec.java","0","0","0","0","0"
"5","StoreIndexExec.java","99780","108724","208504","99780","19956.0"
"5","StoreTableExec.java","0","0","0","0","0"
"5","TunnelExec.java","0","0","0","0","0"
"5","TupleList.java","0","0","0","0","0"
"5","TupleMap.java","0","0","0","0","0"
"5","TupleSet.java","0","0","0","0","0"
"5","TupleSorter.java","96637","198808","295445","96637","19327.0"
"5","UnaryPhysicalExec.java","0","0","0","0","0"
"5","UnionExec.java","0","0","0","0","0"
"5","VectorizedSorter.java","0","0","0","0","0"
"5","WindowAggExec.java","101556","273599","375155","101556","20311.0"
"5","PhysicalPlanner.java","0","0","0","0","0"
"5","PhysicalPlannerImpl.java","83572","378498","462070","141410","28282.0"
"5","PhysicalPlanningException.java","0","0","0","0","0"
"5","Projector.java","84576","423658","508234","132757","26551.0"
"5","RangePartitionAlgorithm.java","0","0","0","0","0"
"5","UniformRangePartition.java","0","0","0","0","0"
"5","QueryContext.java","82222","379398","461620","131023","26204.0"
"5","TaskRequest.java","0","0","0","0","0"
"5","TaskRequestImpl.java","83572","378498","462070","91258","18251.0"
"5","CacheHolder.java","43447","107638","151085","43447","8689.0"
"5","TableCache.java","0","0","0","0","0"
"5","TableCacheKey.java","0","0","0","0","0"
"5","ErrorInjectionRewriter.java","0","0","0","0","0"
"5","TupleUtil.java","84587","423733","508320","138954","27790.0"
"5","HdfsServiceTracker.java","98227","182830","281057","98227","19645.0"
"5","AsyncTaskService.java","0","0","0","0","0"
"5","WorkerConnectionInfo.java","0","0","0","0","0"
"5","FragmentScheduleEvent.java","0","0","0","0","0"
"5","LocalTaskEvent.java","140321","359411","499732","140321","28064.0"
"5","LocalTaskEventType.java","0","0","0","0","0"
"5","QueryCompletedEvent.java","0","0","0","0","0"
"5","QueryDiagnosticsUpdateEvent.java","0","0","0","0","0"
"5","QueryEvent.java","0","0","0","0","0"
"5","QueryEventType.java","0","0","0","0","0"
"5","QueryMasterQueryCompletedEvent.java","0","0","0","0","0"
"5","QueryStartEvent.java","147482","353416","500898","147482","29496.0"
"5","QueryStopEvent.java","108386","212992","321378","108386","21677.0"
"5","StageCompletedEvent.java","0","0","0","0","0"
"5","StageDiagnosticsUpdateEvent.java","0","0","0","0","0"
"5","StageEvent.java","0","0","0","0","0"
"5","StageEventType.java","0","0","0","0","0"
"5","StageShuffleReportEvent.java","0","0","0","0","0"
"5","StageTaskEvent.java","0","0","0","0","0"
"5","StageTaskFailedEvent.java","0","0","0","0","0"
"5","TaskAttemptAssignedEvent.java","0","0","0","0","0"
"5","TaskAttemptEvent.java","0","0","0","0","0"
"5","TaskAttemptEventType.java","0","0","0","0","0"
"5","TaskAttemptScheduleEvent.java","0","0","0","0","0"
"5","TaskAttemptStatusUpdateEvent.java","0","0","0","0","0"
"5","TaskAttemptToSchedulerEvent.java","0","0","0","0","0"
"5","TaskCompletionEvent.java","0","0","0","0","0"
"5","TaskEvent.java","0","0","0","0","0"
"5","TaskEventType.java","0","0","0","0","0"
"5","TaskFatalErrorEvent.java","0","0","0","0","0"
"5","TaskRequestEvent.java","0","0","0","0","0"
"5","TaskSchedulerEvent.java","0","0","0","0","0"
"5","TaskTAttemptEvent.java","0","0","0","0","0"
"5","TaskTAttemptFailedEvent.java","0","0","0","0","0"
"5","CreateTableExecutor.java","3861","7590","11451","3861","772.0"
"5","DDLExecutor.java","54621","128567","183188","54621","10924.0"
"5","ExplainGlobalPlanPreprocessorForTest.java","0","0","0","0","0"
"5","ExplainPlanPreprocessorForTest.java","97313","198915","296228","97313","19462.0"
"5","NonForwardQueryResultFileScanner.java","103859","182855","286714","103859","20771.0"
"5","NonForwardQueryResultScanner.java","146767","269351","416118","146767","29353.0"
"5","NonForwardQueryResultSystemScanner.java","58718","123920","182638","58718","11743.0"
"5","CreateTableHook.java","0","0","0","0","0"
"5","DistributedQueryHook.java","0","0","0","0","0"
"5","DistributedQueryHookManager.java","0","0","0","0","0"
"5","InsertIntoHook.java","0","0","0","0","0"
"5","QueryExecutor.java","62372","134853","197225","62372","12474.0"
"5","GlobalEngine.java","99353","286555","385908","152058","30411.0"
"5","QueryCoordinatorService.java","80948","376569","457517","120607","24121.0"
"5","QueryInfo.java","0","0","0","0","0"
"5","QueryInProgress.java","80948","376569","457517","144724","28944.0"
"5","QueryManager.java","80948","376569","457517","114737","22947.0"
"5","NodeEvent.java","142109","358708","500817","142109","28421.0"
"5","NodeEventType.java","0","0","0","0","0"
"5","NodeLivelinessMonitor.java","142109","358708","500817","142109","28421.0"
"5","NodeReconnectEvent.java","142109","358708","500817","142109","28421.0"
"5","NodeState.java","142109","358708","500817","142109","28421.0"
"5","NodeStatus.java","0","0","0","0","0"
"5","NodeStatusEvent.java","0","0","0","0","0"
"5","TajoResourceManager.java","0","0","0","0","0"
"5","TajoResourceTracker.java","142109","358708","500817","142109","28421.0"
"5","TajoRMContext.java","142109","358708","500817","142109","28421.0"
"5","WorkerResource.java","0","0","0","0","0"
"5","FileSystemRule.java","0","0","0","0","0"
"5","MasterRuleProvider.java","0","0","0","0","0"
"5","AbstractQueryScheduler.java","0","0","0","0","0"
"5","ResourceReserveSchedulerEvent.java","0","0","0","0","0"
"5","SchedulerEvent.java","0","0","0","0","0"
"5","SchedulerEventType.java","0","0","0","0","0"
"5","QuerySchedulingInfo.java","99110","282161","381271","99110","19822.0"
"5","QueueInfo.java","0","0","0","0","0"
"5","QueueState.java","0","0","0","0","0"
"5","Scheduler.java","0","0","0","0","0"
"5","SchedulingAlgorithms.java","99110","282161","381271","99110","19822.0"
"5","SimpleScheduler.java","0","0","0","0","0"
"5","TajoResourceScheduler.java","0","0","0","0","0"
"5","TajoMaster.java","83572","378498","462070","147333","29466.0"
"5","TajoMasterClientService.java","83572","378498","462070","150177","30035.0"
"5","TaskState.java","0","0","0","0","0"
"5","ClusterResourceMetricSet.java","0","0","0","0","0"
"5","SQLAnalyzer.java","77179","383658","460837","157677","31535.0"
"5","SQLErrorListener.java","76524","396039","472563","76524","15304.0"
"5","SQLParseError.java","76524","396039","472563","76524","15304.0"
"5","AbstractTaskScheduler.java","83572","378498","462070","83572","16714.0"
"5","DefaultTaskScheduler.java","83572","378498","462070","148870","29774.0"
"5","FetchScheduleEvent.java","0","0","0","0","0"
"5","Query.java","83572","378498","462070","147333","29466.0"
"5","QueryJobEvent.java","0","0","0","0","0"
"5","QueryMaster.java","77205","376994","454199","149319","29863.0"
"5","QueryMasterManagerService.java","114782","371826","486608","139765","27953.0"
"5","QueryMasterTask.java","80948","376569","457517","154640","30928.0"
"5","Repartitioner.java","84208","389145","473353","154559","30911.0"
"5","Stage.java","59850","130389","190239","59850","11970.0"
"5","StageState.java","0","0","0","0","0"
"5","Task.java","83572","378498","462070","157156","31431.0"
"5","TaskAttempt.java","83572","378498","462070","148834","29766.0"
"5","TaskSchedulerContext.java","0","0","0","0","0"
"5","TaskSchedulerFactory.java","0","0","0","0","0"
"5","DefaultResourceCalculator.java","0","0","0","0","0"
"5","NodeResource.java","0","0","0","0","0"
"5","NodeResources.java","0","0","0","0","0"
"5","ResourceCalculator.java","0","0","0","0","0"
"5","NoSuchSessionVariableException.java","83983","380705","464688","83983","16796.0"
"5","Session.java","0","0","0","0","0"
"5","SessionConstants.java","0","0","0","0","0"
"5","SessionEvent.java","0","0","0","0","0"
"5","SessionEventType.java","0","0","0","0","0"
"5","SessionLivelinessMonitor.java","0","0","0","0","0"
"5","SessionManager.java","148438","356386","504824","148438","29687.0"
"5","ApplicationIdUtils.java","0","0","0","0","0"
"5","GeoIPUtil.java","0","0","0","0","0"
"5","History.java","0","0","0","0","0"
"5","HistoryCleaner.java","0","0","0","0","0"
"5","HistoryReader.java","89762","180485","270247","89762","17952.0"
"5","HistoryWriter.java","86231","173935","260166","86231","17246.0"
"5","QueryHistory.java","0","0","0","0","0"
"5","StageHistory.java","0","0","0","0","0"
"5","TaskHistory.java","86231","173935","260166","138349","27669.0"
"5","IPconvertUtil.java","0","0","0","0","0"
"5","JSPUtil.java","92899","375560","468459","138429","27685.0"
"5","JvmPauseMonitor.java","0","0","0","0","0"
"5","GroupNameMetricsFilter.java","0","0","0","0","0"
"5","LogEventGaugeSet.java","0","0","0","0","0"
"5","MetricsFilterList.java","0","0","0","0","0"
"5","RegexpMetricsFilter.java","0","0","0","0","0"
"5","GangliaReporter.java","0","0","0","0","0"
"5","MetricsConsoleReporter.java","0","0","0","0","0"
"5","MetricsConsoleScheduledReporter.java","0","0","0","0","0"
"5","MetricsFileScheduledReporter.java","0","0","0","0","0"
"5","MetricsStreamScheduledReporter.java","0","0","0","0","0"
"5","NullReporter.java","0","0","0","0","0"
"5","TajoMetricsReporter.java","129232","370379","499611","129232","25846.0"
"5","TajoMetricsScheduledReporter.java","0","0","0","0","0"
"5","TajoJMXObjectNameFactory.java","0","0","0","0","0"
"5","TajoLogEventCounter.java","0","0","0","0","0"
"5","TajoMetrics.java","129236","370559","499795","129236","25847.0"
"5","TajoSystemMetrics.java","129236","370559","499795","129236","25847.0"
"5","RpcParameterFactory.java","0","0","0","0","0"
"5","SplitUtil.java","0","0","0","0","0"
"5","TajoUncaughtExceptionHandler.java","0","0","0","0","0"
"5","TimeZoneUtil.java","0","0","0","0","0"
"5","HttpServer.java","84547","417220","501767","84547","16909.0"
"5","QueryExecutorServlet.java","114604","374499","489103","120088","24017.0"
"5","StaticHttpServer.java","0","0","0","0","0"
"5","AbstractFetcher.java","0","0","0","0","0"
"5","DeletionService.java","0","0","0","0","0"
"5","ExecutionBlockErrorEvent.java","108386","212992","321378","108386","21677.0"
"5","ExecutionBlockStopEvent.java","18376","18104","36480","18376","3675.0"
"5","NodeResourceAllocateEvent.java","24071","29501","53572","24071","4814.0"
"5","NodeResourceDeallocateEvent.java","24071","29501","53572","24071","4814.0"
"5","NodeResourceEvent.java","18376","18104","36480","18376","3675.0"
"5","NodeStatusEvent.java","0","0","0","0","0"
"5","QMResourceAllocateEvent.java","0","0","0","0","0"
"5","QueryStopEvent.java","108386","212992","321378","108386","21677.0"
"5","TaskManagerEvent.java","0","0","0","0","0"
"5","TaskStartEvent.java","18376","18104","36480","18376","3675.0"
"5","ExecutionBlockContext.java","108386","212992","321378","108386","21677.0"
"5","ExecutionBlockSharedResource.java","0","0","0","0","0"
"5","FetchImpl.java","97393","287690","385083","97393","19478.0"
"5","LocalFetcher.java","0","0","0","0","0"
"5","NodeResourceManager.java","24071","29501","53572","24071","4814.0"
"5","NodeStatusUpdater.java","24071","29501","53572","24071","4814.0"
"5","RemoteFetcher.java","95630","186908","282538","129665","25933.0"
"5","ConnectivityCheckerRuleForTajoWorker.java","128612","246199","374811","128612","25722.0"
"5","WorkerRuleProvider.java","0","0","0","0","0"
"5","TajoQueryEngine.java","0","0","0","0","0"
"5","TajoWorker.java","80948","376569","457517","139330","27866.0"
"5","TajoWorkerClientService.java","77624","379209","456833","120735","24147.0"
"5","TajoWorkerManagerService.java","80948","376569","457517","119948","23989.0"
"5","Task.java","83572","378498","462070","157156","31431.0"
"5","TaskAttemptContext.java","84545","415112","499657","154220","30844.0"
"5","TaskContainer.java","0","0","0","0","0"
"5","TaskExecutor.java","18376","18104","36480","18376","3675.0"
"5","TaskHistory.java","86231","173935","260166","138349","27669.0"
"5","TaskImpl.java","18376","18104","36480","18376","3675.0"
"5","TaskManager.java","18376","18104","36480","18376","3675.0"
"5","RestReturnType.java","0","0","0","0","0"
"5","ClientApplication.java","0","0","0","0","0"
"5","JerseyResourceDelegate.java","0","0","0","0","0"
"5","JerseyResourceDelegateContext.java","0","0","0","0","0"
"5","JerseyResourceDelegateContextKey.java","0","0","0","0","0"
"5","JerseyResourceDelegateUtil.java","0","0","0","0","0"
"5","NewDatabaseRequest.java","0","0","0","0","0"
"5","NewSessionRequest.java","0","0","0","0","0"
"5","SubmitQueryRequest.java","0","0","0","0","0"
"5","ClusterResource.java","35483","86544","122027","35483","7096.0"
"5","DatabasesResource.java","46314","107386","153700","46314","9262.0"
"5","FunctionsResource.java","95120","183928","279048","95120","19024.0"
"5","AbstractStreamingOutput.java","0","0","0","0","0"
"5","BinaryStreamingOutput.java","0","0","0","0","0"
"5","CSVStreamingOutput.java","0","0","0","0","0"
"5","RestOutputFactory.java","0","0","0","0","0"
"5","QueryResource.java","27325","80286","107611","27325","5465.0"
"5","QueryResultResource.java","98623","196450","295073","98623","19724.0"
"5","SessionsResource.java","0","0","0","0","0"
"5","TablesResource.java","27128","79851","106979","27128","5425.0"
"5","ResourcesUtil.java","0","0","0","0","0"
"5","DatabaseInfoResponse.java","0","0","0","0","0"
"5","ExceptionResponse.java","0","0","0","0","0"
"5","GetQueryResultDataResponse.java","0","0","0","0","0"
"5","GetSubmitQueryResponse.java","0","0","0","0","0"
"5","NewSessionResponse.java","0","0","0","0","0"
"5","ResultSetInfoResponse.java","0","0","0","0","0"
"5","WorkerConnectionInfoResponse.java","0","0","0","0","0"
"5","WorkerResponse.java","35483","86544","122027","35483","7096.0"
"5","TajoRestService.java","0","0","0","0","0"
"5","TestTPCH.java","0","0","0","0","0"
"5","TestDDLBuilder.java","101626","409356","510982","101626","20325.0"
"5","TestTajoDump.java","158529","356926","515455","158529","31705.0"
"5","TestExecExternalShellCommand.java","0","0","0","0","0"
"5","TestHdfsCommand.java","0","0","0","0","0"
"5","TestDefaultCliOutputFormatter.java","0","0","0","0","0"
"5","TestSimpleParser.java","0","0","0","0","0"
"5","TestTajoCli.java","93856","287656","381512","93856","18771.0"
"5","TestTajoCliNegatives.java","109654","140944","250598","109654","21930.0"
"5","TestCatalogAdminClientExceptions.java","0","0","0","0","0"
"5","TestQueryClientExceptions.java","106912","116183","223095","106912","21382.0"
"5","TestTajoClient.java","135802","364236","500038","150217","30043.0"
"5","TestTajoClientV2.java","3446","5585","9031","3446","689.0"
"5","TestWorkerConnectionInfo.java","0","0","0","0","0"
"5","TestEvalCodeGenerator.java","0","0","0","0","0"
"5","TestGeneratorAdapter.java","0","0","0","0","0"
"5","ExprTestBase.java","93215","377991","471206","146994","29398.0"
"5","TestEvalTree.java","0","0","0","0","0"
"5","TestEvalTreeUtil.java","83983","381308","465291","147333","29466.0"
"5","TestIntervalType.java","0","0","0","0","0"
"5","TestPredicates.java","0","0","0","0","0"
"5","TestSQLDateTimeTypes.java","0","0","0","0","0"
"5","TestSQLExpression.java","101952","286549","388501","127148","25429.0"
"5","HiveUDFtest.java","0","0","0","0","0"
"5","TestHiveFunctionLoader.java","0","0","0","0","0"
"5","TestHiveFunctions.java","0","0","0","0","0"
"5","NullTestFunction.java","0","0","0","0","0"
"5","TestAggFunction.java","0","0","0","0","0"
"5","TestBuiltinFunctions.java","0","0","0","0","0"
"5","TestConditionalExpressions.java","0","0","0","0","0"
"5","TestDateTimeFunctions.java","0","0","0","0","0"
"5","TestFunctionLoader.java","150215","295778","445993","150215","30043.0"
"5","TestGeneralFunction.java","0","0","0","0","0"
"5","TestJsonFunctions.java","46246","106952","153198","46246","9249.0"
"5","TestMathFunctions.java","119262","377557","496819","126418","25283.0"
"5","TestPatternMatchingPredicates.java","0","0","0","0","0"
"5","TestPythonFunctions.java","0","0","0","0","0"
"5","TestStringOperatorsAndFunctions.java","0","0","0","0","0"
"5","TestUserDefinedFunctions.java","0","0","0","0","0"
"5","TestMasterPlan.java","0","0","0","0","0"
"5","TestExternalSortExec.java","83983","381308","465291","147333","29466.0"
"5","TestFullOuterHashJoinExec.java","97986","378206","476192","141143","28228.0"
"5","TestFullOuterMergeJoinExec.java","97986","378206","476192","147333","29466.0"
"5","TestHashAntiJoinExec.java","80151","379263","459414","147333","29466.0"
"5","TestHashJoinExec.java","83983","381308","465291","147333","29466.0"
"5","TestHashPartitioner.java","0","0","0","0","0"
"5","TestHashSemiJoinExec.java","127466","232694","360160","147333","29466.0"
"5","TestLeftOuterHashJoinExec.java","97986","378206","476192","147333","29466.0"
"5","TestMergeJoinExec.java","83572","378498","462070","147333","29466.0"
"5","TestPhysicalPlanner.java","83983","381308","465291","147333","29466.0"
"5","TestProgressExternalSortExec.java","149900","369799","519699","149900","29980.0"
"5","TestRadixSort.java","0","0","0","0","0"
"5","TestRightOuterHashJoinExec.java","98375","396575","494950","147333","29466.0"
"5","TestRightOuterMergeJoinExec.java","97986","378206","476192","147333","29466.0"
"5","TestSortExec.java","84059","384589","468648","138600","27720.0"
"5","TestSortIntersectExec.java","112995","131080","244075","112995","22599.0"
"5","TestTupleSorter.java","41314","102190","143504","41314","8262.0"
"5","TestUnSafeTuple.java","0","0","0","0","0"
"5","TestEvalNodeToExprConverter.java","0","0","0","0","0"
"5","TestJoinOrderAlgorithm.java","0","0","0","0","0"
"5","TestLogicalOptimizer.java","83983","381308","465291","147333","29466.0"
"5","TestLogicalPlan.java","93091","414659","507750","93091","18618.0"
"5","TestLogicalPlanner.java","83567","381754","465321","157498","31499.0"
"5","TestPlannerUtil.java","0","0","0","0","0"
"5","TestQueryValidation.java","147935","264817","412752","147935","29587.0"
"5","TestUniformRangePartition.java","0","0","0","0","0"
"5","TestAlterTable.java","27280","86473","113753","148486","29697.0"
"5","TestAlterTablespace.java","0","0","0","0","0"
"5","TestCaseByCases.java","0","0","0","0","0"
"5","TestCommonConditionReduce.java","0","0","0","0","0"
"5","TestCreateDatabase.java","0","0","0","0","0"
"5","TestCreateIndex.java","0","0","0","0","0"
"5","TestCreateTable.java","148435","356200","504635","155480","31096.0"
"5","TestCrossJoin.java","0","0","0","0","0"
"5","TestCTASQuery.java","0","0","0","0","0"
"5","TestDropTable.java","0","0","0","0","0"
"5","TestGroupByQuery.java","99383","277362","376745","151340","30268.0"
"5","TestHBaseTable.java","71495","152828","224323","71495","14299.0"
"5","TestIndexScan.java","0","0","0","0","0"
"5","TestInnerJoinQuery.java","0","0","0","0","0"
"5","TestInnerJoinWithSubQuery.java","124473","150320","274793","124473","24894.0"
"5","TestInsertQuery.java","83026","419794","502820","147333","29466.0"
"5","TestInSubquery.java","0","0","0","0","0"
"5","TestJoinOnPartitionedTables.java","32672","41452","74124","146888","29377.0"
"5","TestJoinQuery.java","117163","138948","256111","146888","29377.0"
"5","TestJsonWithTimezone.java","0","0","0","0","0"
"5","TestMultipleJoinTypes.java","29163","38196","67359","29163","5832.0"
"5","TestNullValues.java","84587","423670","508257","139801","27960.0"
"5","TestOuterJoinQuery.java","0","0","0","0","0"
"5","TestOuterJoinWithSubQuery.java","0","0","0","0","0"
"5","TestQueryOnSelfDescTable.java","1515","5833","7348","1515","303.0"
"5","TestSelectNestedRecord.java","39148","90524","129672","39148","7829.0"
"5","TestSelectQuery.java","84217","392799","477016","156619","31323.0"
"5","TestSetSessionQuery.java","130433","261567","392000","130433","26086.0"
"5","TestSimpleQuery.java","0","0","0","0","0"
"5","TestSortQuery.java","135655","337871","473526","146543","29308.0"
"5","TestTablePartitions.java","131358","370108","501466","147333","29466.0"
"5","TestTableSubQuery.java","0","0","0","0","0"
"5","TestTimezone.java","0","0","0","0","0"
"5","TestTruncateTable.java","0","0","0","0","0"
"5","TestUnionQuery.java","134272","364060","498332","146889","29377.0"
"5","TestWindowQuery.java","0","0","0","0","0"
"5","BenchmarkSort.java","0","0","0","0","0"
"5","TestTableCache.java","0","0","0","0","0"
"5","TestTupleUtil.java","0","0","0","0","0"
"5","TestHAServiceHDFSImpl.java","142283","341970","484253","142283","28456.0"
"5","TestMasterRules.java","0","0","0","0","0"
"5","TestSimpleScheduler.java","0","0","0","0","0"
"5","TestExecutionBlockCursor.java","0","0","0","0","0"
"5","TestNonForwardQueryResultSystemScanner.java","0","0","0","0","0"
"5","TestQueryResult.java","0","0","0","0","0"
"5","TestRepartitioner.java","103646","264465","368111","103646","20729.0"
"5","TestSQLAnalyzer.java","77440","393686","471126","77440","15488.0"
"5","TestIntermediateEntry.java","0","0","0","0","0"
"5","TestKillQuery.java","108575","213380","321955","108575","21715.0"
"5","TestQueryProgress.java","0","0","0","0","0"
"5","TestQueryState.java","31801","77988","109789","31801","6360.0"
"5","TestTaskStatusUpdate.java","143386","363075","506461","143386","28677.0"
"5","TestResources.java","0","0","0","0","0"
"5","TestFileFragment.java","0","0","0","0","0"
"5","TestQueryOnOrcFile.java","0","0","0","0","0"
"5","TestQueryIdFactory.java","0","0","0","0","0"
"5","TestTajoIds.java","0","0","0","0","0"
"5","TestHistoryWriterReader.java","89762","180485","270247","89762","17952.0"
"5","TestJMXTajoObjectNameFactory.java","0","0","0","0","0"
"5","TestMetricsFilter.java","0","0","0","0","0"
"5","TestSystemMetrics.java","129236","370559","499795","129236","25847.0"
"5","TestIPconvertUtil.java","0","0","0","0","0"
"5","TestJSPUtil.java","145259","398256","543515","145259","29051.0"
"5","TestRpcParamFactory.java","0","0","0","0","0"
"5","TestTimeZoneUtil.java","0","0","0","0","0"
"5","MockExecutionBlockContext.java","0","0","0","0","0"
"5","MockNodeResourceManager.java","18376","18104","36480","18376","3675.0"
"5","MockNodeStatusUpdater.java","24071","29501","53572","24071","4814.0"
"5","MockTaskExecutor.java","18376","18104","36480","18376","3675.0"
"5","MockTaskManager.java","18376","18104","36480","18376","3675.0"
"5","MockWorkerContext.java","0","0","0","0","0"
"5","TestDeletionService.java","0","0","0","0","0"
"5","TestFetcherWithTajoPullServer.java","0","0","0","0","0"
"5","TestNodeResourceManager.java","24071","29501","53572","24071","4814.0"
"5","TestNodeStatusUpdater.java","24071","29501","53572","24071","4814.0"
"5","TestTaskExecutor.java","18376","18104","36480","18376","3675.0"
"5","TestTaskManager.java","18376","18104","36480","18376","3675.0"
"5","TestClusterResource.java","0","0","0","0","0"
"5","TestDatabasesResource.java","0","0","0","0","0"
"5","TestFunctionsResource.java","0","0","0","0","0"
"5","TestQueryResource.java","27325","80286","107611","27325","5465.0"
"5","TestQueryResultResource.java","27325","80286","107611","27325","5465.0"
"5","TestSessionsResource.java","0","0","0","0","0"
"5","TestTablesResource.java","27128","79851","106979","27128","5425.0"
"5","JdbcConnection.java","148691","362497","511188","148691","29738.0"
"5","TajoDatabaseMetaData.java","118419","373348","491767","129209","25841.0"
"5","TajoDriver.java","0","0","0","0","0"
"5","TajoPreparedStatement.java","120346","135450","255796","120346","24069.0"
"5","TajoStatement.java","118419","373348","491767","143322","28664.0"
"5","QueryStringDecoder.java","0","0","0","0","0"
"5","TestResultSet.java","84322","398530","482852","141216","28243.0"
"5","TestSQLState.java","0","0","0","0","0"
"5","TestTajoDatabaseMetaData.java","158642","391835","550477","158642","31728.0"
"5","TestTajoJdbc.java","117961","374355","492316","155440","31088.0"
"5","TestTajoJdbcNegative.java","6339","9293","15632","6339","1267.0"
"5","TestQueryStringDecoder.java","0","0","0","0","0"
"5","TestResultSetUtil.java","0","0","0","0","0"
"5","ProtocMojo.java","0","0","0","0","0"
"5","Exec.java","0","0","0","0","0"
"5","FileSetUtils.java","0","0","0","0","0"
"5","VersionInfoMojo.java","0","0","0","0","0"
"5","MetricsUtil.java","0","0","0","0","0"
"5","TestMetricsUtil.java","0","0","0","0","0"
"5","AlgebraVisitor.java","77524","380379","457903","77524","15504.0"
"5","BaseAlgebraVisitor.java","77524","380379","457903","155480","31096.0"
"5","Prioritized.java","0","0","0","0","0"
"5","AggregationFunctionCallEval.java","0","0","0","0","0"
"5","AlgebraicException.java","0","0","0","0","0"
"5","AlgebraicUtil.java","84059","384589","468648","130826","26165.0"
"5","BasicEvalNodeVisitor.java","93007","387224","480231","121578","24315.0"
"5","BetweenPredicateEval.java","0","0","0","0","0"
"5","BinaryEval.java","84217","392534","476751","129920","25984.0"
"5","CaseWhenEval.java","0","0","0","0","0"
"5","CastEval.java","0","0","0","0","0"
"5","ConstEval.java","0","0","0","0","0"
"5","EvalContext.java","0","0","0","0","0"
"5","EvalNode.java","0","0","0","0","0"
"5","EvalNodeVisitor.java","0","0","0","0","0"
"5","EvalNodeVisitor2.java","0","0","0","0","0"
"5","EvalTreeFactory.java","0","0","0","0","0"
"5","EvalTreeUtil.java","84208","389836","474044","156703","31340.0"
"5","EvalType.java","77737","389209","466946","91366","18273.0"
"5","FieldEval.java","0","0","0","0","0"
"5","FunctionEval.java","0","0","0","0","0"
"5","GeneralFunctionEval.java","83983","380705","464688","135710","27142.0"
"5","InEval.java","81784","419742","501526","145668","29133.0"
"5","InvalidEvalException.java","0","0","0","0","0"
"5","IsNullEval.java","0","0","0","0","0"
"5","LikePredicateEval.java","0","0","0","0","0"
"5","NotEval.java","0","0","0","0","0"
"5","PartialBinaryExpr.java","0","0","0","0","0"
"5","PatternMatchPredicateEval.java","0","0","0","0","0"
"5","RegexPredicateEval.java","0","0","0","0","0"
"5","RowConstantEval.java","0","0","0","0","0"
"5","SignedEval.java","0","0","0","0","0"
"5","SimilarToPredicateEval.java","0","0","0","0","0"
"5","SimpleEvalNodeVisitor.java","100517","297002","397519","100517","20103.0"
"5","SubqueryEval.java","0","0","0","0","0"
"5","UnaryEval.java","0","0","0","0","0"
"5","ValueSetEval.java","0","0","0","0","0"
"5","WindowFunctionEval.java","0","0","0","0","0"
"5","ExprAnnotator.java","134808","363604","498412","154335","30867.0"
"5","ExprNormalizer.java","134808","363604","498412","134808","26961.0"
"5","EvalTreeOptimizationRule.java","0","0","0","0","0"
"5","EvalTreeOptimizer.java","0","0","0","0","0"
"5","ConstantFolding.java","140067","336613","476680","140067","28013.0"
"5","ConstantPropagation.java","0","0","0","0","0"
"5","AggFunction.java","0","0","0","0","0"
"5","AggFunctionInvoke.java","0","0","0","0","0"
"5","ClassBasedAggFunctionInvoke.java","0","0","0","0","0"
"5","ClassBasedScalarFunctionInvoke.java","0","0","0","0","0"
"5","FunctionContext.java","0","0","0","0","0"
"5","FunctionInvoke.java","83256","142984","226240","83256","16651.0"
"5","FunctionInvokeContext.java","0","0","0","0","0"
"5","GeneralFunction.java","0","0","0","0","0"
"5","HiveFunctionInvoke.java","0","0","0","0","0"
"5","PythonScriptEngine.java","83529","143788","227317","83529","16705.0"
"5","TajoScriptEngine.java","0","0","0","0","0"
"5","PythonAggFunctionInvoke.java","0","0","0","0","0"
"5","PythonFunctionInvoke.java","0","0","0","0","0"
"5","BufferPool.java","87743","149076","236819","87743","17548.0"
"5","ByteBufInputChannel.java","0","0","0","0","0"
"5","ByteBufLineReader.java","0","0","0","0","0"
"5","CSVLineDeserializer.java","129671","256951","386622","129671","25934.0"
"5","CSVLineSerDe.java","130137","258635","388772","130137","26027.0"
"5","CSVLineSerializer.java","0","0","0","0","0"
"5","FieldSerializerDeserializer.java","0","0","0","0","0"
"5","FieldSplitProcessor.java","0","0","0","0","0"
"5","InputHandler.java","0","0","0","0","0"
"5","LineSplitProcessor.java","0","0","0","0","0"
"5","OutputHandler.java","0","0","0","0","0"
"5","StreamingUtil.java","0","0","0","0","0"
"5","TextFieldSerializerDeserializer.java","0","0","0","0","0"
"5","TextLineDeserializer.java","0","0","0","0","0"
"5","TextLineParsingError.java","0","0","0","0","0"
"5","TextLineSerDe.java","88765","175829","264594","88765","17753.0"
"5","TextLineSerializer.java","0","0","0","0","0"
"5","WindowAggFunc.java","0","0","0","0","0"
"5","Edge.java","0","0","0","0","0"
"5","FoundJoinOrder.java","0","0","0","0","0"
"5","GreedyHeuristicJoinOrderAlgorithm.java","114909","376647","491556","135938","27187.0"
"5","JoinEdge.java","100877","377154","478031","100877","20175.0"
"5","JoinedRelationsVertex.java","0","0","0","0","0"
"5","JoinGraph.java","100877","377154","478031","100877","20175.0"
"5","JoinGraphContext.java","18640","16847","35487","18640","3728.0"
"5","JoinOrderAlgorithm.java","114909","376647","491556","119906","23981.0"
"5","JoinOrderingUtil.java","22597","29806","52403","22597","4519.0"
"5","JoinVertex.java","0","0","0","0","0"
"5","RelationVertex.java","0","0","0","0","0"
"5","AlterTableNode.java","151019","355352","506371","151019","30203.0"
"5","AlterTablespaceNode.java","0","0","0","0","0"
"5","BinaryNode.java","0","0","0","0","0"
"5","CreateDatabaseNode.java","0","0","0","0","0"
"5","CreateIndexNode.java","0","0","0","0","0"
"5","CreateTableNode.java","84545","416586","501131","147333","29466.0"
"5","DistinctGroupbyNode.java","128510","349755","478265","128510","25702.0"
"5","DropDatabaseNode.java","0","0","0","0","0"
"5","DropIndexNode.java","0","0","0","0","0"
"5","DropTableNode.java","0","0","0","0","0"
"5","EvalExprNode.java","84576","423658","508234","133792","26758.0"
"5","ExceptNode.java","0","0","0","0","0"
"5","GroupbyNode.java","84576","423658","508234","141045","28209.0"
"5","GroupElement.java","0","0","0","0","0"
"5","HavingNode.java","0","0","0","0","0"
"5","IndexScanNode.java","84059","384589","468648","92357","18471.0"
"5","InsertNode.java","83056","421580","504636","141466","28293.0"
"5","IntersectNode.java","0","0","0","0","0"
"5","JoinNode.java","83567","382932","466499","139583","27916.0"
"5","JoinSpec.java","0","0","0","0","0"
"5","LimitNode.java","0","0","0","0","0"
"5","LogicalNode.java","0","0","0","0","0"
"5","LogicalNodeVisitor.java","0","0","0","0","0"
"5","LogicalRootNode.java","0","0","0","0","0"
"5","NodeType.java","77571","382999","460570","123744","24748.0"
"5","PartitionedTableScanNode.java","132234","413344","545578","132234","26446.0"
"5","PersistentStoreNode.java","0","0","0","0","0"
"5","Projectable.java","0","0","0","0","0"
"5","ProjectionNode.java","84576","423658","508234","151735","30347.0"
"5","RelationNode.java","0","0","0","0","0"
"5","ScanNode.java","84545","415025","499570","126804","25360.0"
"5","SelectableNode.java","0","0","0","0","0"
"5","SelectionNode.java","0","0","0","0","0"
"5","SetOperationNode.java","0","0","0","0","0"
"5","SetSessionNode.java","0","0","0","0","0"
"5","ShuffleFileWriteNode.java","0","0","0","0","0"
"5","SortNode.java","0","0","0","0","0"
"5","StoreTableNode.java","84545","416586","501131","141466","28293.0"
"5","TableSubQueryNode.java","93152","421129","514281","93152","18630.0"
"5","TruncateTableNode.java","0","0","0","0","0"
"5","UnaryNode.java","0","0","0","0","0"
"5","UnionNode.java","0","0","0","0","0"
"5","WindowAggNode.java","134154","347585","481739","134154","26830.0"
"5","WindowSpec.java","0","0","0","0","0"
"5","LogicalOptimizer.java","83567","382932","466499","128255","25651.0"
"5","LogicalPlan.java","77102","380376","457478","154974","30994.0"
"5","LogicalPlanner.java","83567","381281","464848","155049","31009.0"
"5","LogicalPlanPreprocessor.java","135500","380493","515993","135500","27100.0"
"5","NamedExprsManager.java","0","0","0","0","0"
"5","NameResolver.java","104663","270420","375083","104663","20932.0"
"5","NameResolvingMode.java","0","0","0","0","0"
"5","ResolverByLegacy.java","106180","277410","383590","106180","21236.0"
"5","ResolverByRels.java","137762","338235","475997","137762","27552.0"
"5","ResolverByRelsAndSubExprs.java","137762","338235","475997","137762","27552.0"
"5","ResolverBySubExprsAndRels.java","137762","338235","475997","137762","27552.0"
"5","PlanString.java","93091","414659","507750","93091","18618.0"
"5","BaseLogicalPlanPreprocessEngine.java","0","0","0","0","0"
"5","BaseLogicalPlanPreprocessPhaseProvider.java","0","0","0","0","0"
"5","BaseLogicalPlanRewriteEngine.java","0","0","0","0","0"
"5","BaseLogicalPlanRewriteRuleProvider.java","67172","146683","213855","67172","13434.0"
"5","BaseSchemaBuildPhase.java","2958","22080","25038","2958","591.0"
"5","LogicalPlanPreprocessEngine.java","0","0","0","0","0"
"5","LogicalPlanPreprocessPhase.java","0","0","0","0","0"
"5","LogicalPlanPreprocessPhaseProvider.java","0","0","0","0","0"
"5","LogicalPlanRewriteEngine.java","0","0","0","0","0"
"5","LogicalPlanRewriteRule.java","0","0","0","0","0"
"5","LogicalPlanRewriteRuleContext.java","115965","156612","272577","115965","23193.0"
"5","LogicalPlanRewriteRuleProvider.java","0","0","0","0","0"
"5","LogicalPlanTestRuleProvider.java","0","0","0","0","0"
"5","AccessPathInfo.java","0","0","0","0","0"
"5","AccessPathRewriter.java","0","0","0","0","0"
"5","CommonConditionReduceRule.java","95581","98270","193851","95581","19116.0"
"5","FilterPushDownRule.java","76023","379796","455819","154686","30937.0"
"5","IndexScanInfo.java","0","0","0","0","0"
"5","InSubqueryRewriteRule.java","0","0","0","0","0"
"5","LogicalPlanEqualityTester.java","65395","138862","204257","65395","13079.0"
"5","PartitionedTableRewriter.java","131358","370711","502069","136489","27297.0"
"5","ProjectionPushDownRule.java","76023","379796","455819","147605","29521.0"
"5","SeqScanInfo.java","0","0","0","0","0"
"5","SelfDescSchemaBuildPhase.java","1515","5833","7348","1515","303.0"
"5","TableStatUpdateRewriter.java","5027","8110","13137","5027","1005.0"
"5","EvalNodeAdapter.java","0","0","0","0","0"
"5","EvalNodeDeserializer.java","110345","276080","386425","110345","22069.0"
"5","EvalNodeSerializer.java","110426","277798","388224","110426","22085.0"
"5","LogicalNodeAdapter.java","0","0","0","0","0"
"5","LogicalNodeDeserializer.java","51709","122833","174542","51709","10341.0"
"5","LogicalNodeSerializer.java","60435","130697","191132","60435","12087.0"
"5","package-info.java","0","0","0","0","0"
"5","PlanGsonHelper.java","0","0","0","0","0"
"5","StorageService.java","123914","158234","282148","123914","24782.0"
"5","TablePropertyUtil.java","127059","169535","296594","127059","25411.0"
"5","Target.java","0","0","0","0","0"
"5","TypeDeterminant.java","101142","272816","373958","101142","20228.0"
"5","EvalNodeToExprConverter.java","5892","9575","15467","5892","1178.0"
"5","ExprFinder.java","134808","364207","499015","134808","26961.0"
"5","PartitionFilterAlgebraVisitor.java","0","0","0","0","0"
"5","PlannerUtil.java","83983","381308","465291","157498","31499.0"
"5","WritableTypeConverter.java","0","0","0","0","0"
"5","ExprsVerifier.java","115067","415470","530537","127633","25526.0"
"5","LogicalPlanVerifier.java","114348","374419","488767","146859","29371.0"
"5","PostLogicalPlanVerifier.java","0","0","0","0","0"
"5","PreLogicalPlanVerifier.java","136371","363897","500268","146859","29371.0"
"5","SyntaxErrorException.java","114440","374153","488593","114440","22888.0"
"5","SyntaxErrorUtil.java","113147","127045","240192","113147","22629.0"
"5","VerificationState.java","114348","374419","488767","114348","22869.0"
"5","BasicLogicalPlanVisitor.java","75593","381406","456999","153254","30650.0"
"5","ExplainLogicalPlanVisitor.java","92493","378713","471206","128255","25651.0"
"5","LogicalPlanVisitor.java","76023","379796","455819","130110","26022.0"
"5","SimpleAlgebraVisitor.java","134808","364207","499015","134808","26961.0"
"5","TestExprAnnotator.java","0","0","0","0","0"
"5","TestLogicalNode.java","0","0","0","0","0"
"5","TestWritableTypeConverter.java","0","0","0","0","0"
"5","FadvisedChunkedFile.java","0","0","0","0","0"
"5","FadvisedFileRegion.java","0","0","0","0","0"
"5","FileAccessForbiddenException.java","0","0","0","0","0"
"5","FileCloseListener.java","0","0","0","0","0"
"5","HttpDataServerChannelInitializer.java","0","0","0","0","0"
"5","HttpDataServerHandler.java","84547","417220","501767","84547","16909.0"
"5","HttpUtil.java","0","0","0","0","0"
"5","PullServerConstants.java","0","0","0","0","0"
"5","PullServerUtil.java","0","0","0","0","0"
"5","AdvancedDataRetriever.java","0","0","0","0","0"
"5","DataRetriever.java","0","0","0","0","0"
"5","DirectoryRetriever.java","0","0","0","0","0"
"5","FileChunk.java","0","0","0","0","0"
"5","FileChunkMeta.java","0","0","0","0","0"
"5","IndexCacheKey.java","0","0","0","0","0"
"5","RetrieverHandler.java","0","0","0","0","0"
"5","TajoPullServer.java","0","0","0","0","0"
"5","TajoPullServerService.java","98022","204613","302635","129831","25966.0"
"5","NettyServerBase.java","97421","204081","301502","138480","27696.0"
"5","NettyUtils.java","6187","30766","36953","6187","1237.0"
"5","RemoteException.java","0","0","0","0","0"
"5","RetriesExhaustedException.java","0","0","0","0","0"
"5","RpcConstants.java","0","0","0","0","0"
"5","RpcEventListener.java","0","0","0","0","0"
"5","RpcUtils.java","0","0","0","0","0"
"5","AsyncRpcClient.java","91835","174446","266281","113984","22796.0"
"5","AsyncRpcServer.java","83572","378498","462070","139172","27834.0"
"5","BlockingRpcClient.java","84322","397766","482088","134671","26934.0"
"5","BlockingRpcServer.java","0","0","0","0","0"
"5","CallFuture.java","0","0","0","0","0"
"5","CancelableRpcCallback.java","0","0","0","0","0"
"5","ChannelEventListener.java","0","0","0","0","0"
"5","DefaultRpcController.java","0","0","0","0","0"
"5","MonitorClientHandler.java","0","0","0","0","0"
"5","MonitorServerHandler.java","0","0","0","0","0"
"5","MonitorStateEvent.java","0","0","0","0","0"
"5","NettyClientBase.java","90585","153968","244553","92863","18572.0"
"5","NettyRpcController.java","0","0","0","0","0"
"5","NullCallback.java","0","0","0","0","0"
"5","ProtoClientChannelInitializer.java","95669","196539","292208","95669","19133.0"
"5","ProtoDeclaration.java","0","0","0","0","0"
"5","ProtoServerChannelInitializer.java","0","0","0","0","0"
"5","RecoverableException.java","0","0","0","0","0"
"5","RemoteCallException.java","0","0","0","0","0"
"5","RpcClientManager.java","93261","161635","254896","93261","18652.0"
"5","RpcConnectionKey.java","0","0","0","0","0"
"5","TajoServiceException.java","0","0","0","0","0"
"5","DummyProtocolAsyncImpl.java","0","0","0","0","0"
"5","DummyProtocolBlockingImpl.java","0","0","0","0","0"
"5","TestAsyncRpc.java","84545","417217","501762","149374","29874.0"
"5","TestBlockingRpc.java","84545","417217","501762","149374","29874.0"
"5","TestRpcClientManager.java","94323","181925","276248","94323","18864.0"
"5","GsonFeature.java","0","0","0","0","0"
"5","GsonReader.java","0","0","0","0","0"
"5","GsonUtil.java","0","0","0","0","0"
"5","GsonWriter.java","0","0","0","0","0"
"5","NettyRestChannelInitializer.java","0","0","0","0","0"
"5","NettyRestHandlerContainer.java","0","0","0","0","0"
"5","NettyRestHandlerContainerProvider.java","0","0","0","0","0"
"5","NettyRestServer.java","0","0","0","0","0"
"5","NettyRestServerFactory.java","0","0","0","0","0"
"5","NettyRestServerListener.java","0","0","0","0","0"
"5","ResourceConfigUtil.java","0","0","0","0","0"
"5","NettyRestHandlerContainerProviderTest.java","0","0","0","0","0"
"5","NettyRestServerTest.java","0","0","0","0","0"
"5","TestApplication1.java","0","0","0","0","0"
"5","TestResource1.java","0","0","0","0","0"
"5","DirectoriesDao.java","0","0","0","0","0"
"5","DirectoriesResource.java","0","0","0","0","0"
"5","Directory.java","0","0","0","0","0"
"5","FileManagementApplication.java","0","0","0","0","0"
"5","AbstractScanner.java","84967","154628","239595","84967","16993.0"
"5","ForSplitableStore.java","0","0","0","0","0"
"5","Appender.java","84573","423058","507631","84573","16914.0"
"5","BaseTupleComparator.java","126971","262752","389723","126971","25394.0"
"5","BinarySerializerDeserializer.java","118906","403266","522172","129960","25992.0"
"5","ByteBufInputChannel.java","0","0","0","0","0"
"5","CodecPool.java","0","0","0","0","0"
"5","DataLocation.java","0","0","0","0","0"
"5","DiskDeviceInfo.java","0","0","0","0","0"
"5","DiskInfo.java","0","0","0","0","0"
"5","DiskMountInfo.java","0","0","0","0","0"
"5","DiskUtil.java","0","0","0","0","0"
"5","AlreadyExistsStorageException.java","0","0","0","0","0"
"5","UnknownCodecException.java","0","0","0","0","0"
"5","UnsupportedFileTypeException.java","0","0","0","0","0"
"5","FormatProperty.java","0","0","0","0","0"
"5","BuiltinFragmentKinds.java","0","0","0","0","0"
"5","Fragment.java","0","0","0","0","0"
"5","FragmentConvertor.java","0","0","0","0","0"
"5","FragmentSerde.java","0","0","0","0","0"
"5","FrameTuple.java","83983","381677","465660","137868","27573.0"
"5","FSDataInputChannel.java","85801","148391","234192","85801","17160.0"
"5","InputChannel.java","0","0","0","0","0"
"5","LazyTuple.java","138836","362903","501739","138836","27767.0"
"5","LocalFileInputChannel.java","41398","95910","137308","41398","8279.0"
"5","MergeScanner.java","84217","392368","476585","143293","28658.0"
"5","NullScanner.java","106029","190576","296605","106029","21205.0"
"5","NumericPathComparator.java","0","0","0","0","0"
"5","OldStorageManager.java","0","0","0","0","0"
"5","RowStoreUtil.java","84217","392368","476585","154633","30926.0"
"5","Scanner.java","84545","415025","499570","84545","16909.0"
"5","SeekableChannel.java","0","0","0","0","0"
"5","SeekableInputChannel.java","0","0","0","0","0"
"5","SeekableScanner.java","0","0","0","0","0"
"5","SerializerDeserializer.java","0","0","0","0","0"
"5","StorageProperty.java","0","0","0","0","0"
"5","StorageUtil.java","0","0","0","0","0"
"5","Tablespace.java","69968","146894","216862","69968","13993.0"
"5","TablespaceManager.java","119525","133662","253187","119525","23905.0"
"5","TableStatistics.java","143733","404428","548161","143733","28746.0"
"5","TextSerializerDeserializer.java","0","0","0","0","0"
"5","TupleComparator.java","0","0","0","0","0"
"5","TupleRange.java","0","0","0","0","0"
"5","TestFrameTuple.java","0","0","0","0","0"
"5","TestLazyTuple.java","0","0","0","0","0"
"5","TestTupleComparator.java","84573","422600","507173","84573","16914.0"
"5","TestVTuple.java","0","0","0","0","0"
"5","AbstractHBaseAppender.java","71495","152828","224323","71495","14299.0"
"5","ColumnMapping.java","71495","152828","224323","71495","14299.0"
"5","HBaseBinarySerializerDeserializer.java","0","0","0","0","0"
"5","HBaseFragment.java","0","0","0","0","0"
"5","HBaseFragmentSerde.java","0","0","0","0","0"
"5","HBasePutAppender.java","0","0","0","0","0"
"5","HBaseScanner.java","71495","152828","224323","71495","14299.0"
"5","HBaseStorageConstants.java","0","0","0","0","0"
"5","HBaseTablespace.java","69968","146894","216862","69968","13993.0"
"5","HBaseTextSerializerDeserializer.java","0","0","0","0","0"
"5","HFileAppender.java","0","0","0","0","0"
"5","IndexPredication.java","0","0","0","0","0"
"5","RegionSizeCalculator.java","0","0","0","0","0"
"5","RowKeyMapping.java","0","0","0","0","0"
"5","SortedInsertRewriter.java","26550","30920","57470","56224","11244.0"
"5","TestColumnMapping.java","116215","231739","347954","116215","23243.0"
"5","TestHBaseTableSpace.java","113411","220287","333698","113411","22682.0"
"5","AvroAppender.java","160265","391040","551305","160265","32053.0"
"5","AvroScanner.java","0","0","0","0","0"
"5","AvroUtil.java","160703","397933","558636","160703","32140.0"
"5","package-info.java","0","0","0","0","0"
"5","FieldSerializerDeserializer.java","0","0","0","0","0"
"5","FileAppender.java","84573","423058","507631","102949","20589.0"
"5","FileScanner.java","84545","415025","499570","84545","16909.0"
"5","FileTablespace.java","144812","279512","424324","144812","28962.0"
"5","AbstractFileFragment.java","0","0","0","0","0"
"5","FileFragment.java","0","0","0","0","0"
"5","FileFragmentSerde.java","0","0","0","0","0"
"5","HashShuffleAppenderManager.java","144643","343056","487699","144643","28928.0"
"5","HashShuffleAppenderWrapper.java","143976","336073","480049","143976","28795.0"
"5","BSTIndex.java","83983","381677","465660","127871","25574.0"
"5","IndexMethod.java","0","0","0","0","0"
"5","IndexReader.java","0","0","0","0","0"
"5","IndexWriter.java","0","0","0","0","0"
"5","OrderIndexReader.java","0","0","0","0","0"
"5","JsonLineDeserializer.java","90613","182630","273243","90613","18122.0"
"5","JsonLineSerDe.java","0","0","0","0","0"
"5","JsonLineSerializer.java","90613","182630","273243","90613","18122.0"
"5","ORCAppender.java","5455","17689","23144","5455","1091.0"
"5","OrcScanner.java","0","0","0","0","0"
"5","package-info.java","0","0","0","0","0"
"5","package-info.java","0","0","0","0","0"
"5","ParquetAppender.java","153228","399798","553026","153228","30645.0"
"5","ParquetScanner.java","151951","368187","520138","151951","30390.0"
"5","TajoParquetReader.java","0","0","0","0","0"
"5","TajoParquetWriter.java","0","0","0","0","0"
"5","TajoReadSupport.java","0","0","0","0","0"
"5","TajoRecordConverter.java","153299","402479","555778","153299","30659.0"
"5","TajoRecordMaterializer.java","153299","402479","555778","153299","30659.0"
"5","TajoSchemaConverter.java","0","0","0","0","0"
"5","TajoWriteSupport.java","152974","397906","550880","152974","30594.0"
"5","DirectRawFileScanner.java","105778","116572","222350","105778","21155.0"
"5","DirectRawFileWriter.java","4513","9802","14315","4513","902.0"
"5","RawFile.java","84576","423565","508141","138350","27670.0"
"5","BytesRefArrayWritable.java","0","0","0","0","0"
"5","BytesRefWritable.java","0","0","0","0","0"
"5","ColumnProjectionUtils.java","0","0","0","0","0"
"5","LazyDecompressionCallback.java","0","0","0","0","0"
"5","NonSyncByteArrayInputStream.java","0","0","0","0","0"
"5","NonSyncByteArrayOutputStream.java","0","0","0","0","0"
"5","NonSyncDataInputBuffer.java","0","0","0","0","0"
"5","NonSyncDataOutputBuffer.java","0","0","0","0","0"
"5","RCFile.java","118385","374188","492573","155346","31069.0"
"5","SchemaAwareCompressionInputStream.java","0","0","0","0","0"
"5","SchemaAwareCompressionOutputStream.java","0","0","0","0","0"
"5","RegexLineDeserializer.java","0","0","0","0","0"
"5","RegexLineSerDe.java","0","0","0","0","0"
"5","RegexLineSerializer.java","0","0","0","0","0"
"5","SequenceFileAppender.java","155388","398936","554324","155388","31077.0"
"5","SequenceFileScanner.java","153034","355791","508825","153034","30606.0"
"5","ByteBufLineReader.java","0","0","0","0","0"
"5","CSVLineDeserializer.java","129671","256951","386622","129671","25934.0"
"5","CSVLineSerDe.java","130137","258635","388772","130137","26027.0"
"5","CSVLineSerializer.java","0","0","0","0","0"
"5","DelimitedLineReader.java","121122","225316","346438","121122","24224.0"
"5","DelimitedTextFile.java","88158","181895","270053","88158","17631.0"
"5","FieldSplitProcessor.java","0","0","0","0","0"
"5","LineSplitProcessor.java","0","0","0","0","0"
"5","MultiBytesFieldSplitProcessor.java","0","0","0","0","0"
"5","TextFieldSerializerDeserializer.java","0","0","0","0","0"
"5","TextLineDeserializer.java","0","0","0","0","0"
"5","TextLineParsingError.java","0","0","0","0","0"
"5","TextLineSerDe.java","88765","175829","264594","88765","17753.0"
"5","TextLineSerializer.java","0","0","0","0","0"
"5","ByteBufferAllocatorPool.java","0","0","0","0","0"
"5","ByteBufferPoolAdapter.java","0","0","0","0","0"
"5","OrcConf.java","0","0","0","0","0"
"5","OrcFile.java","0","0","0","0","0"
"5","OrcRecordReader.java","0","0","0","0","0"
"5","OrcUtils.java","0","0","0","0","0"
"5","package-info.java","0","0","0","0","0"
"5","RecordReaderUtils.java","0","0","0","0","0"
"5","TreeReaderFactory.java","0","0","0","0","0"
"5","BloomFilter.java","0","0","0","0","0"
"5","Murmur3.java","0","0","0","0","0"
"5","Writer.java","0","0","0","0","0"
"5","WriterImpl.java","0","0","0","0","0"
"5","ZeroCopyAdapter.java","0","0","0","0","0"
"5","InternalParquetRecordReader.java","0","0","0","0","0"
"5","ParquetReader.java","0","0","0","0","0"
"5","HttpFileServer.java","0","0","0","0","0"
"5","HttpFileServerChannelInitializer.java","0","0","0","0","0"
"5","HttpFileServerHandler.java","0","0","0","0","0"
"5","TestAvroUtil.java","129588","258715","388303","129588","25917.0"
"5","TestBSTIndex.java","84555","420907","505462","141613","28322.0"
"5","TestSingleCSVFileBSTIndex.java","84555","420907","505462","141321","28264.0"
"5","TestJsonSerDe.java","122663","219137","341800","122663","24532.0"
"5","TestReadWrite.java","0","0","0","0","0"
"5","TestSchemaConverter.java","0","0","0","0","0"
"5","TestDirectRawFile.java","105778","116572","222350","105778","21155.0"
"5","TestRegexSerDe.java","0","0","0","0","0"
"5","TestByteBufLineReader.java","0","0","0","0","0"
"5","TestCompressionStorages.java","81428","418880","500308","151867","30373.0"
"5","TestDelimitedTextFile.java","88815","174609","263424","88815","17763.0"
"5","TestFileSystems.java","0","0","0","0","0"
"5","TestFileTablespace.java","84322","396814","481136","155271","31054.0"
"5","TestLineReader.java","121070","224153","345223","121070","24214.0"
"5","TestMergeScanner.java","83983","381677","465660","118324","23664.0"
"5","TestSplitProcessor.java","0","0","0","0","0"
"5","TestStorages.java","84320","394076","478396","156926","31385.0"
"5","TestStorageUtil.java","0","0","0","0","0"
"5","ConnectionInfo.java","0","0","0","0","0"
"5","JdbcFragment.java","0","0","0","0","0"
"5","JdbcFragmentSerde.java","0","0","0","0","0"
"5","JdbcMetadataProviderBase.java","0","0","0","0","0"
"5","JdbcScanner.java","0","0","0","0","0"
"5","JdbcTablespace.java","0","0","0","0","0"
"5","SQLBuilder.java","0","0","0","0","0"
"5","SQLExpressionGenerator.java","0","0","0","0","0"
"5","TestConnectionInfo.java","0","0","0","0","0"
"5","KafkaFragment.java","0","0","0","0","0"
"5","KafkaFragmentSerde.java","0","0","0","0","0"
"5","KafkaScanner.java","0","0","0","0","0"
"5","KafkaStorageConstants.java","0","0","0","0","0"
"5","KafkaTablespace.java","0","0","0","0","0"
"5","SimpleConsumerManager.java","0","0","0","0","0"
"5","KafkaTestUtil.java","0","0","0","0","0"
"5","EmbeddedKafka.java","0","0","0","0","0"
"5","EmbeddedZookeeper.java","0","0","0","0","0"
"5","TestKafkaQuery.java","0","0","0","0","0"
"5","TestKafkaScanner.java","0","0","0","0","0"
"5","TestKafkaTablespace.java","0","0","0","0","0"
"5","TestSimpleConsumerManager.java","0","0","0","0","0"
"5","PgSQLJdbcScanner.java","0","0","0","0","0"
"5","PgSQLMetadataProvider.java","0","0","0","0","0"
"5","PgSQLTablespace.java","0","0","0","0","0"
"5","PgSQLTestServer.java","0","0","0","0","0"
"5","TestPgSQLEndPointTests.java","0","0","0","0","0"
"5","TestPgSQLJdbcTableSpace.java","446","708","1154","446","89.0"
"5","TestPgSQLMetadataProvider.java","0","0","0","0","0"
"5","TestPgSQLQueryTests.java","0","0","0","0","0"
"5","TestPgSQLSimpleQueryTests.java","0","0","0","0","0"
"5","AnonymousAWSCredentialsProvider.java","0","0","0","0","0"
"5","BasicAWSCredentialsProvider.java","0","0","0","0","0"
"5","S3TableSpace.java","1998","1485","3483","1998","399.0"
"5","TajoS3Constants.java","0","0","0","0","0"
"5","MockAmazonS3.java","0","0","0","0","0"
"5","MockObjectListing.java","0","0","0","0","0"
"5","MockS3FileSystem.java","0","0","0","0","0"
"5","TestS3TableSpace.java","0","0","0","0","0"
"5","ExampleHttpFileFragment.java","0","0","0","0","0"
"5","ExampleHttpFileFragmentSerde.java","0","0","0","0","0"
"5","ExampleHttpFileTablespace.java","0","0","0","0","0"
"5","ExampleHttpJsonLineReader.java","0","0","0","0","0"
"5","ExampleHttpJsonScanner.java","0","0","0","0","0"
"5","ExampleHttpServerHandler.java","0","0","0","0","0"
"5","ExampleHttpServerInitializer.java","0","0","0","0","0"
"5","ExampleHttpTablespaceTestServer.java","0","0","0","0","0"
"5","TestExampleHttpFileQuery.java","0","0","0","0","0"
"5","AnnotationVisitor.java","0","0","0","0","0"
"5","AnnotationWriter.java","0","0","0","0","0"
"5","Attribute.java","0","0","0","0","0"
"5","ByteVector.java","0","0","0","0","0"
"5","ClassReader.java","0","0","0","0","0"
"5","ClassVisitor.java","0","0","0","0","0"
"5","ClassWriter.java","0","0","0","0","0"
"5","AdviceAdapter.java","0","0","0","0","0"
"5","AnalyzerAdapter.java","145946","289520","435466","145946","29189.0"
"5","CodeSizeEvaluator.java","0","0","0","0","0"
"5","GeneratorAdapter.java","0","0","0","0","0"
"5","InstructionAdapter.java","0","0","0","0","0"
"5","JSRInlinerAdapter.java","145946","289520","435466","145946","29189.0"
"5","LocalVariablesSorter.java","0","0","0","0","0"
"5","Method.java","0","0","0","0","0"
"5","Remapper.java","0","0","0","0","0"
"5","RemappingAnnotationAdapter.java","0","0","0","0","0"
"5","RemappingClassAdapter.java","0","0","0","0","0"
"5","RemappingFieldAdapter.java","0","0","0","0","0"
"5","RemappingMethodAdapter.java","0","0","0","0","0"
"5","RemappingSignatureAdapter.java","0","0","0","0","0"
"5","SerialVersionUIDAdder.java","0","0","0","0","0"
"5","SimpleRemapper.java","0","0","0","0","0"
"5","StaticInitMerger.java","0","0","0","0","0"
"5","TableSwitchGenerator.java","0","0","0","0","0"
"5","TryCatchBlockSorter.java","0","0","0","0","0"
"5","Context.java","0","0","0","0","0"
"5","Edge.java","0","0","0","0","0"
"5","FieldVisitor.java","0","0","0","0","0"
"5","FieldWriter.java","0","0","0","0","0"
"5","Frame.java","0","0","0","0","0"
"5","Handle.java","0","0","0","0","0"
"5","Handler.java","0","0","0","0","0"
"5","Item.java","0","0","0","0","0"
"5","Label.java","0","0","0","0","0"
"5","MethodVisitor.java","0","0","0","0","0"
"5","MethodWriter.java","0","0","0","0","0"
"5","Opcodes.java","0","0","0","0","0"
"5","AnnotationConstantsCollector.java","0","0","0","0","0"
"5","ClassConstantsCollector.java","0","0","0","0","0"
"5","ClassOptimizer.java","0","0","0","0","0"
"5","Constant.java","0","0","0","0","0"
"5","ConstantPool.java","0","0","0","0","0"
"5","FieldConstantsCollector.java","0","0","0","0","0"
"5","JarOptimizer.java","0","0","0","0","0"
"5","MethodConstantsCollector.java","0","0","0","0","0"
"5","MethodOptimizer.java","0","0","0","0","0"
"5","NameMapping.java","0","0","0","0","0"
"5","Shrinker.java","0","0","0","0","0"
"5","SignatureReader.java","0","0","0","0","0"
"5","SignatureVisitor.java","0","0","0","0","0"
"5","SignatureWriter.java","0","0","0","0","0"
"5","AbstractInsnNode.java","0","0","0","0","0"
"5","Analyzer.java","145946","289520","435466","145946","29189.0"
"5","AnalyzerException.java","0","0","0","0","0"
"5","BasicInterpreter.java","0","0","0","0","0"
"5","BasicValue.java","0","0","0","0","0"
"5","BasicVerifier.java","0","0","0","0","0"
"5","Frame.java","0","0","0","0","0"
"5","Interpreter.java","0","0","0","0","0"
"5","SimpleVerifier.java","0","0","0","0","0"
"5","SmallSet.java","0","0","0","0","0"
"5","SourceInterpreter.java","0","0","0","0","0"
"5","SourceValue.java","0","0","0","0","0"
"5","Subroutine.java","0","0","0","0","0"
"5","Value.java","0","0","0","0","0"
"5","AnnotationNode.java","0","0","0","0","0"
"5","ClassNode.java","0","0","0","0","0"
"5","FieldInsnNode.java","0","0","0","0","0"
"5","FieldNode.java","0","0","0","0","0"
"5","FrameNode.java","0","0","0","0","0"
"5","IincInsnNode.java","0","0","0","0","0"
"5","InnerClassNode.java","0","0","0","0","0"
"5","InsnList.java","0","0","0","0","0"
"5","InsnNode.java","0","0","0","0","0"
"5","IntInsnNode.java","0","0","0","0","0"
"5","InvokeDynamicInsnNode.java","0","0","0","0","0"
"5","JumpInsnNode.java","0","0","0","0","0"
"5","LabelNode.java","0","0","0","0","0"
"5","LdcInsnNode.java","0","0","0","0","0"
"5","LineNumberNode.java","0","0","0","0","0"
"5","LocalVariableNode.java","0","0","0","0","0"
"5","LookupSwitchInsnNode.java","0","0","0","0","0"
"5","MethodInsnNode.java","0","0","0","0","0"
"5","MethodNode.java","0","0","0","0","0"
"5","MultiANewArrayInsnNode.java","0","0","0","0","0"
"5","TableSwitchInsnNode.java","0","0","0","0","0"
"5","TryCatchBlockNode.java","0","0","0","0","0"
"5","TypeInsnNode.java","0","0","0","0","0"
"5","VarInsnNode.java","0","0","0","0","0"
"5","Type.java","0","0","0","0","0"
"5","ASMifiable.java","0","0","0","0","0"
"5","ASMifier.java","0","0","0","0","0"
"5","CheckAnnotationAdapter.java","0","0","0","0","0"
"5","CheckClassAdapter.java","0","0","0","0","0"
"5","CheckFieldAdapter.java","0","0","0","0","0"
"5","CheckMethodAdapter.java","145946","289520","435466","145946","29189.0"
"5","CheckSignatureAdapter.java","0","0","0","0","0"
"5","Printer.java","0","0","0","0","0"
"5","Textifiable.java","0","0","0","0","0"
"5","Textifier.java","0","0","0","0","0"
"5","TraceAnnotationVisitor.java","0","0","0","0","0"
"5","TraceClassVisitor.java","0","0","0","0","0"
"5","TraceFieldVisitor.java","0","0","0","0","0"
"5","TraceMethodVisitor.java","0","0","0","0","0"
"5","TraceSignatureVisitor.java","0","0","0","0","0"
"5","ASMContentHandler.java","145946","289520","435466","145946","29189.0"
"5","Processor.java","0","0","0","0","0"
"5","SAXAdapter.java","0","0","0","0","0"
"5","SAXAnnotationAdapter.java","0","0","0","0","0"
"5","SAXClassAdapter.java","0","0","0","0","0"
"5","SAXCodeAdapter.java","0","0","0","0","0"
"5","SAXFieldAdapter.java","0","0","0","0","0"
"5","FadvisedChunkedFile.java","0","0","0","0","0"
"5","FadvisedFileRegion.java","0","0","0","0","0"
"5","FileCloseListener.java","0","0","0","0","0"
"5","TajoPullServerService.java","98022","204613","302635","129831","25966.0"
